Aa^bor^li^yon	อา^ปอ^ลิ^โยน
Aa^haa^laa	อา^หะ^ลา
Aa^haa^su^e^latv	อา^หะ^สุ^เอ^ลัด
Aa^haa^waa	อา^หะ^วา
Aa^hi	อา^หิ
Aa^hi^aa	อา^หิ^อา
Aa^hi^hutv	อา^หิ^ฮู้ด
Aa^hi^kam	อา^หิ^คัม
Aa^hi^laa	อา^หิ^ลา
Aa^hi^lam	อา^หิ^ลัม
Aa^hi^lutv	อา^หิ^ลู้ด
Aa^hi^maa^atc	อา^หิ^มา^อัด
Aa^hi^maan	อา^หิ^มาน
Aa^hi^me^lekv	อา^หิ^เม^เล้ก
Aa^hi^motv	อา^หิ^โม้ด
Aa^hi^naa^ndapc	อา^หิ^นา^ดับ
Aa^hi^no^am	อา^หิ^โน^อัม
Aa^hi^qaa	อา^หิ^ชา
Aa^hi^qaa^haa	อา^หิ^ชา^ฮา
Aa^hi^saa^makv	อา^หิ^สะ^มัก
Aa^hi^to^fen	อา^หิ^โท^เฟน
Aa^hi^tupv	อา^หิ^ทู้บ
Aa^hi^yaa	อา^หิ^ยา
Aa^hi^yam	อา^หิ^ยัม
Aa^hi^yan	อา^หิ^ยัน
Aa^hi^ye^se	อา^หิ^เย^เซ
Aa^hi^yo	อา^หิ^โย
Aa^hu^mai	อา^หุ^ไม
Aa^kuin^laa	อา^ควิน^ลา
Aa^laa^maa^getc^ndon	อา^ละ^มา^เกด^โดน
Aa^laa^mbie	อา^ละ^เบีย
Aa^le^okc	อา^เล^โอก
Aa^li^maa^tie	อา^ลิ^มา^เทีย
Aa^li^okc	อา^ลี^โอก
Aa^maa^li^yaa	อา^มา^ลิ^ยา
Aa^maa^si^yaa	อา^มา^ซิ^ยา
Aa^mben Maa^im	อา^เบน^มา^อิม
Aa^mben Mbetc Maa^aa^kaa	อา^เบน^เบด^มา^อะ^คา
Aa^mbi^hutv	อา^บี^ฮู้ด
Aa^mbi^tupv	อา^บี^ทู้บ
Aa^mbipc	อา^บีบ
Aa^mo^lai	อา^โม^ไล
Aa^naa^haa^laatv	อา^นา^หะ^ล้าด
Aa^naa^ni	อา^นา^นี
Aa^ndin	อา^ดีน
Aa^ndun^lam	อา^ดุน^ลัม
Aa^saa^li^yaa	อา^ซา^ลิ^ยา
Aa^saa^si^yaa	อา^ซา^ซิ^ยา
Aa^se^natv	อา^เส^นัด
Aa^si^en	อา^สิ^เอน
Aa^si^maa	อา^ซิ^มา
Aa^su^mbaa	อา^ซุ^บา
Aa^taa^li^yaa	อา^ทา^ลิ^ยา
Aa^taa^lotv	อา^ทา^โล้ด
Aa^taa^lotv Atc^ndaa	อา^ทา^โล้ด^อัด^ดา
Aafekv	อา^เฟ้ก
Aagakc	อา^กัก
Aagu	อา^กู
Aakitv	อา^คิด
Aalaa	อา^ลา
Aalaatv	อา^ล้าด
Aalam	อา^ลัม
Aalam Maa^aa^kaa	อา^ลัม^มา^อะ^คา
Aalam So^mbaa	อา^ลัม^โซ^บา
Aalan	อา^ลัน
Aalapc	อา^หลับ
Aalon	อา^โลน
Aalotv	อา^โล้ด
Aalutv	อา^ลู้ด
Aamam	อา^มัม
Aamen	อา^เมน
Aami	อา^มี
Aamon	อา^โมน
Aan^gopc	อาน^โกบ
Aan^taa^se^sitv	อาน^ทา^เซ^ซี้ด
Aanaa	อา^นา
Aanaakv	อา^น้าก
Aanaapv	อา^น้าบ
Aanem	อา^เนม
Aanim	อา^นิม
Aankaa	อาน^คา
Aanki	อาน^คี
Aannan	อาน^นัน
Aanni	อาน^นี
Aannon	อาน^โนน
Aanupv	อา^นู้บ
Aanwatv	อาน^วัด
Aaqan	อา^ชัน
Aasaapc	อา^สาบ
Aasaatv	อา^ซ้าด
Aasaax	อา^สา
Aase	อา^เซ
Aasen	อา^เซน
Aasor	อา^ซอ
Aataakv	อา^ท้าก
Aate	อา^เท
Aaten	อะ^เทน
Aawitv	อา^วี้ด
Aayin	อา^ยิน
Aiyaa	ไอ^ยา
Akc^kupc	อัก^ขูบ
Akc^sipv	อัก^ซี้บ
Am^fi^mbu^li	อัม^ฟี^บุ^ลี
Am^mi^hutv	อัม^มี^ฮู้ด
Am^mi^saa^mbaatc	อัม^มี^ซะ^บาด
Am^paa^li^aa^tatv	อัม^พะ^ลี^อา^ทัด
Amlaam	อัม^ลาม
Ammon	อัม^โมน
Amnon	อัม^โนน
Amsi	อัม^ซี
An^ndo^ni^katv	อัน^โด^นิ^คัด
An^ti^baa^di	อัน^ทิ^ปา^ตี
An^ti^baatc	อัน^ทิ^ปาด
An^ti^okc	อัน^ที^โอก
Anlon	อัน^โลน
Anlon Mbaakutv	อัน^โลน^บา^คุด
Anmon Ndipc^laa^taa^im	อัน^โมน^ดิบ^ลา^ทา^อิม
Annaa	อัน^นา
Annaatv	อัน^น้าด
Anwaan	อัน^วาน
Aqv loh	อ๊ะโล่ะ
Atc^laa^mitv^ti^yum	อัด^ลา^มิด^ทิ^ยุม
Atc^lotv Mbetc Yo^aapc	อัด^โล้ด^เบด^โย^อาบ
Atc^lotv Sofaan	อัด^โล้ด^โซ^ฟาน
Atc^notv Taa^mbo	อัด^โน้ด^ทา^โบ
Atc^si	อัด^สี
Atc^si^lie	อัด^ซี^เลีย
Atc^taa^li^yaa	อัด^ทา^ลิ^ยา
Atc^taa^lotv	อัด^ทา^โล้ด
Baa^hatc Mo^apc	ปา^หัด^โม^อับ
Baa^laa^di^yaa	ปา^ลา^ติ^ยา
Baa^se^aa	ปา^เส^อา
Baafotv	ปา^โฟ้ด
Baalaa	ปา^ลา
Baalaan	ปา^ลาน
Baalotv	ปา^โล้ด
Baasakc	ปา^สัก
Banlu	ปัน^ลู
Banti	ปัน^ที
Batc^lotv	ปัด^โล้ด
Batc^lu^simx	ปัด^ลุ^สิม
Batc^ndaan Aalam	ปัด^ดาน^อา^ลัม
Baulo	เปา^โล
Be^kaa^hi^yaa	เป^คา^หิ^ยา
Be^laa^li^yaa	เป^ลา^ลิ^ยา
Be^lu^ndaa	เป^ลุ^ดา
Be^taa^hi^yaa	เป^ทา^หิ^ยา
Be^tu^en	เป^ทุ^เอน
Begaa	เป^กา
Bekaa	เป^คา
Bekotc	เป^โขด
Belekv	เป^เล้ก
Beletv	เป^เล้ด
Beletv Utc^saa	เป^เล้ด^อุด^ซา
Belon	เป^โลน
Besie	เป^เซีย
Bi^haa^hi^lotv	ปี^หะ^หิ^โล้ด
Bi^laa^ton	ปิ^ลา^โทน
Bi^si^ndie	ปิ^สิ^เดีย
Bide	ปี^เต
Bilaatv	ปี^ล้าด
Bilatv	ปี^ลัด
Binon	ปี^โนน
Bison	ปี^โซน
Bitom	ปิ^โทม
Biton	ปิ^โทน
Bo^ti^faa	โป^ทิ^ฟา
Bo^ti^fe^laa	โป^ทิ^เฟ^ลา
Bor^si^atc	ปอ^สิ^อัด
Born^ti^atc	ปอน^ทิ^อัด
Bu^ti^en	ปู^ทิ^เอน
Bulaa	ปู^ลา
Bulim	ปู^ลิม
Bunle	ปุน^เล
Bupc^li^atc	ปุบ^ลิ^อัด
Butai	ปุ^ไท
Daa^ko^ni^ditc	ตา^โค^นิ^ติด
E^baa^fo^ndi^tatv	เอ^ปา^โฟ^ดิ^ทัด
E^bi^ku^lien	เอ^ปิ^คู^เลียน
E^hutv	เอ^ฮู้ด
E^li^fe^le^hu	เอ^ลี^เฟ^เล^หุ
E^li^se^aa	เอ^ลี^เซ^อา
E^li^se^mbaa	เอ^ลี^เซ^บา
E^li^utc	เอ^ลี^อูด
E^li^yaa^sipv	เอ^ลี^ยา^ซี้บ
E^saa^laa	เอ^สะ^ลา
E^saa^li	เอ^สะ^ลี
E^se^ken	เอ^เส^เคน
E^si^on Ge^mbe	เอ^ซี^โอน^เก^เบ
Edaam	เอ^ตาม
Efaa	เอ^ฟา
Efaan	เอ^ฟาน
Efe	เอ^เฟ
Eke	เอ^เค
Ekon	เอ^โคน
Elaa	เอ^ลา
Elaam	เอ^ลาม
Elatv	เอ^ลัด
Elekv	เอ^เล้ก
Eli	เอ^ลี
Elim	เอ^ลิม
Elon	เอ^โลน
Elotv	เอ^โล้ด
Elun	เอ^ลูน
Em^maa^utc	เอม^มา^อูด
Emekv Kesitv	เอ^เม้ก^เค^ซี้ด
En E^lo^he I^saa^laa^en	เอน^เอ^โล^เฮ^อี^ซา^ลา^เอน
En Gannim	เอน^กัน^นิม
En Ge^ndi	เอน^เก^ดี
En Haaso	เอน^ฮา^โซ
En Mbelitv	เอน^เบ^ลี้ด
En Mbetc^en	เอน^เบด^เอน
En Semetv	เอน^เซ^เม้ด
Enkotc	เอน^โขด
Enokv	เอ^โน้ก
Enotv	เอ^โน้ด
Esaau	เอ^ซาว
Ese	เอ^เซ
Esekv	เอ^เซ้ก
Esem	เอ^เซม
Esie	เอ^เซีย
Etaan	เอ^ทาน
Etc Kaasin	เอด^คา^ซิน
Ewi	เอ^วี
Faa^le^gon	ฟะ^เล^โกน
Faalo	ฟา^โล
Faalo Neko	ฟา^โล^เน^โค
Fe^saa^tatv	เฟ^สะ^ทัด
Felikv	เฟ^ลิก
Fi^li^saa^die	ฟี^ลิ^สะ^เตีย
Fi^nikv	ฟี^นิก
Fiko	ฟี^โค
Filipv	ฟี^ลิบ
Gaa^li^li	กา^ลิ^ลี
Gaa^maa^li^en	กา^มา^ลิ^เอน
Gaalaan	กา^ลาน
Gaalepv	กา^เล้บ
Gaamatv	กา^มัด
Gaamun	กา^มุน
Gaasaa	กา^ซา
Gaataam	กา^ทาม
Gan^li^o	กัน^ลิ^โอ
Ganlim	กัน^ลิม
Gatc Hefe	กัด^เฮ^เฟ
Gatc Limmon	กัด^ลิม^โมน
Ge Haa^laa^sim	เก^หะ^ลา^ซิม
Ge^haa^si	เก^หะ^ซี
Ge^li^lotv	เก^ลี^โล้ด
Ge^li^sim	เก^ลิ^ซิม
Ge^maa^li^yaa	เก^มา^ลิ^ยา
Ge^ndaa^li^yaa	เก^ดา^ลิ^ยา
Ge^nde^lotv	เก^เด^โล้ด
Gelaa	เก^ลา
Gelem	เก^เลม
Gelutv Kim^ham	เก^ลู้ด^คิม^ฮัม
Gesaan	เก^ซาน
Gese	เก^เซ
Gesem	เก^เซม
Gesom	เก^โซม
Geson	เก^โซน
Gesu	เก^ซู
Getc^se^maa^ni	เกด^เส^มา^นี
Gete	เก^เท
Gi^laa^lai	กิ^ลา^ไล
Gi^le^aatc	กิ^เล^อาด
Gi^mbe^aa	กิ^เบ^อา
Gi^mbe^atc E^lo^him	กิ^เบ^อัด^เอ^โล^ฮิม
Gi^mbe^atc Haa^laa^lotv	กิ^เบ^อัด^ฮา^ลา^โล้ด
Gi^mbe^on	กิ^เบ^โอน
Gi^nde^o^ni	กิ^เด^โอ^นี
Gi^nde^on	กิ^เด^โอน
Gi^ndom	กิ^โดม
Giduc	กี^ตู่
Gilon	กิ^โลน
Gimso	กิม^โซ
Gin^gaan	กิน^กาน
Gin^mbo^aa	กิน^โบ^อา
Go^li^atc	โก^ลิ^อัด
Gokc	โกก
Golaan	โก^ลาน
Gomaa	โก^มา
Gopc	โกบ
Gosaan	โก^ซาน
Gosen	โก^เซน
Gu^aa Mbaa^an	กู^อา^บา^อัน
Guni	กุ^นี
Haa^e^lepv	หะ^เอ^เล้บ
Haa^hi^lotv	หะ^หิ^โล้ด
Haa^kaa^li^yaa	ฮา^คา^ลิ^ยา
Haa^le^lu Yaa	ฮา^เล^ลู^ยา
Haa^lo^setv Haa^go^yim	ฮา^โล^เซ้ด^ฮา^โก^ยิม
Haa^lu^mapv	ฮา^ลุ^มับ
Haa^mbaa^gukc	ฮา^บา^กุก
Haa^mu^taan	ฮา^มุ^ทาน
Haa^saa^bi^yaa	ฮา^ซา^ปิ^ยา
Haa^saa^son Taamaa	ฮา^ซา^โซน^ทา^มา
Haa^saax^ndi^yaa	ฮา^สา^ดิ^ยา
Haa^se^lotv	ฮา^เซ^โล้ด
Haa^ti^faa	ฮา^ทิ^ฟา
Haa^ti^taa	ฮา^ทิ^ทา
Haa^wi^laa	ฮา^วิ^ลา
Haa^yaa^ni^yaa	หะ^ยา^นิ^ยา
Haagaa	ฮา^กา
Haagi	ฮา^กี
Haalaa	ฮา^ลา
Haalaan	ฮา^ลาน
Haalakv	ฮา^ลัก
Haaletv	ฮา^เล้ด
Haalim	ฮา^ลิม
Haalipv	ฮา^ลิบ
Haalotv	ฮา^โล้ด
Haalum	ฮา^ลูม
Haalupv	ฮา^ลู้บ
Haalutv	ฮา^ลุด
Haamaan	ฮา^มาน
Haamatv	ฮา^มัด
Haamo	ฮา^โม
Haamun	ฮา^มูน
Haanan	ฮา^นัน
Haanokv	ฮา^โน้ก
Haanun	ฮา^นูน
Haasaa Enan	ฮา^ซา^เอ^นัน
Haasaa Lenon	ฮา^ซา^เล^โนน
Haasaan Sux^simx	ฮา^ซาน^สู^สิม
Haase Hatv^ti^kon	ฮา^เซ^ฮัด^ทิ^โคน
Haasem	ฮา^เซม
Haaso	ฮา^โซ
Haaso Haa^ndatc^taa	ฮา^โซ^ฮา^ดัด^ทา
Haasum	ฮา^ซูม
Haataatv	ฮา^ท้าด
Haawaa	ฮา^วา
Hakv^gitc	ฮัก^กีด
Hakv^kotc	ฮัก^โขด
Hamlaan	ฮัม^ลาน
Hammon	ฮัม^โมน
Han^hun	ฮัน^ฮูน
Hannaa	ฮัน^นา
Hatc^se^nu^aa	หัด^เส^นู^อา
Hatc^so^fe^letv	หัด^โส^เฟ^เล้ด
Hatc^supv	หัด^ซู้บ
Haulaan	เฮา^ลาน
He^letv^se	เฮ^เล้ด^เส
He^li^o^mbu^li	เฮ^ลี^โอ^บุ^ลี
He^lo^ndi^on	เฮ^โล^ดิ^โอน
He^se^ki^yaa	เฮ^เซ^คี^ยา
He^si^on	เฮ^ซี^โอน
Hefe	เฮ^เฟ
Hegai	เฮ^ไก
Helaa	เฮ^ลา
Heletv	เฮ^เล้ด
Helotv	เฮ^โล้ด
Hemaan	เฮ^มาน
Hemon	เฮ^โมน
Hepv^si^mbaa	เฮ้บ^ซี^บา
Hesi	เฮ^ซี
Hi^e^laa^mbu^li	ฮี^เอ^ลา^บุ^ลี
Hilaam	ฮี^ลาม
Hilen	ฮี^เลน
Hiwai	ฮี^ไว
Ho Hakv^gitc^gaatc	โฮ^ฮัก^กีด^กาด
Ho^ndaa^wi^yaa	โฮ^ดา^วิ^ยา
Holepv	โฮ^เล้บ
Holi	โฮ^ลี
Homaa	โฮ^มา
Homam	โฮ^มัม
Hosaax	โฮ^สา
Hotaam	โฮ^ทาม
Hoti	โฮ^ที
Hotv	โฮ้ด
Hufaam	หุ^ฟาม
Hugorkc	หุ^กอก
Hukc^gorkc	หุก^กอก
Hulaam	หุ^ลาม
Hulaam Aa^mbi	หุ^ลาม^อา^บี
Hulai	หุ^ไล
Huli	หุ^ลี
Hun	ฮูน
Hun^ndaa	ฮุน^ดา
Husaa	หุ^ซา
Husaam	หุ^ซาม
Husai	หุ^ไซ
Husim	หุ^ซิม
Huwaa	ฮู^วา
I^daa^li	อิ^ตา^ลี
I^ko^ni^yum	อี^โค^นี^ยูม
I^laa^aa	อิ^ลา^อา
I^li^yaa	อิ^ลี^ยา
I^ndaa^laa	อิ^ดา^ลา
I^ndu^me^aa	อิ^ดู^เม^อา
I^opc	อิ^โอบ
I^saa^kaa^li^otc	อิ^สะ^คา^ลิ^โอด
I^saa^laa	อิ^สะ^ลา
I^saa^laa^en	อิ^สะ^ลา^เอน
I^saa^laa^hi^yaa	อิ^สะ^ลา^หิ^ยา
I^saa^li	อิ^สะ^ลี
I^saa^li^yaa	อิ^สะ^ลิ^ยา
I^saa^maa^en	อิ^สะ^มา^เอน
I^saa^yaa	อิ^สะ^ยา
I^taa^maa	อิ^ทา^มา
I^ti^en	อิ^ที^เอน
I^tu^lie	อิ^ทู^เลีย
I^ye Aa^mbaa^lim	อี^เย^อา^บา^ลิม
I^ye^aa^laa^mbim	อิ^เย^อา^ลา^บิม
I^yon	อิ^โยน
Igaan	อิ^กาน
Ikc^ketc	อิก^เขด
Ikc^ndaa^li^yaa	อิก^ดา^ลิ^ยา
Ilaa	อิ^ละ
Ilaa Naahaatc	อิ^ละ^นา^หาด
Ilaam	อิ^ลาม
Ilaanc	อิ^หล่าน
Ilaatv	อิ^ล้าด
Ilai	อิ^ไล
Ilaqv	อี^ละ
Ili	อิ^ลี
Ilu	อิ^ลู
Imlaa	อิม^ลา
Imli	อิม^ลี
Imme	อิม^เม
Imnaa	อิม^นา
In Semetv	อิน^เซ^เม้ด
In^li^kum	อิน^ลี^ลิ^คุม
Ipc^taa En	อิบ^ทา^เอน
Isakc	อี^สัก
Itai	อิ^ไท
Itc^hotv	อิด^โฮ้ด
Itc^mbi Mbenopv	อิด^บี^เบ^โน้บ
Itc^saa^maa^ki^yaa	อิด^สะ^มา^คิ^ยา
Itc^wi	อิด^วี
Itv^hotv	อิ๊ด^โฮ้ด
Iu-Mienh	ยิว-เมี่ยน
Iyim	อิ^ยิม
Iyipv	อี^ยิบ
Jetc^si	เจียด^ซี
Jor^laa^kev	จระเข้
Kaa^laau^ndi^atc	คา^ลาว^ดิ^อัด
Kaa^litv^batc	คะ^ลิด^ปัด
Kaa^lo^e	คะ^โล^เอ
Kaa^ndetc Mbaa^nie	คา^เดด^บา^เนีย
Kaa^si^fie	คา^สิ^เฟีย
Kaalepv	คา^เล้บ
Kaan^ndaa^si	คาน^ดา^สี
Kaanaa	คา^นา
Kaanko	คาน^โค
Kaanmen	คาน^เมน
Kaanmi	คาน^มี
Kaantaa	คาน^ทา
Kaasetv	คา^เซ้ด
Ke^len^hapc^bukc	เค^เลน^หับ^ปุก
Ke^li^otc	เค^ลิ^โอด
Ke^li^otc Hetv^lon	เค^ลิ^โอด^เฮ้ด^โลน
Ke^li^taa	เค^ลิ^ทา
Ke^litv^taa	เค^ลี้ด^ทา
Ke^lu^hi	เค^ลุ^ฮี
Ke^lu^mbai	เค^ลุ^ไบ
Ke^lu^mbim	เค^ลู^บิม
Ke^naa^aa^naa	เค^นา^อะ^นา
Ke^saa^lon	เค^สะ^โลน
Ke^si^yaa	เค^สิ^ยา
Ke^sunx^lotv	เค^สุน^โล้ด
Kelaan	เค^ลาน
Kelitv	เค^ลี้ด
Kelotv	เค^โล้ด
Kelupv	เค^ลู้บ
Kenaatv	เค^น้าด
Kenai	เค^ไน
Kenan	เค^นัน
Kenatv	เค^นัด
Kesipv	เค^ซี้บ
Ki^le^aapc	คิ^เล^อาบ
Ki^li^ni^atc	คี^ลิ^นิ^อัด
Ki^li^on	คิ^ลิ^โอน
Ki^li^yaa^taa^im	คี^ลิ^ยา^ทา^อิม
Ki^li^yaatv	คี^ลิ^ย้าด
Ki^li^yaatv Aalim	คี^ลิ^ย้าด^อา^ลิม
Ki^li^yaatv Aan^mbaa	คี^ลิ^ย้าด^อาน^บา
Ki^li^yaatv Husotv	คี^ลิ^ย้าด^หุ^โซ้ด
Ki^li^yaatv Mbaa^an	คี^ลิ^ย้าด^บา^อัน
Ki^li^yaatv Sanx^naa	คี^ลิ^ย้าด^สัน^นา
Ki^li^yaatv Sefe	คี^ลิ^ย้าด^เส^เฟ
Ki^li^yaatv Ye^aa^lim	คี^ลิ^ย้าด^เย^อา^ลิม
Ki^ndon	คิ^โดน
Ki^si^on	คี^ซิ^โอน
Kin Haa^le^setv	คีน^หะ^เล^เซ้ด
Kinaa	คี^นา
Kipc^lotv Hatc^daa^aa^waa	ขิบ^โล้ด^หัด^ตา^อา^วา
Kisi	คี^ซี
Kison	คี^โซน
Kitv	คี้ด
Kitv^lepv	คิด^เล้บ
Kitv^litv	คิด^ลิด
Kitv^liu	คิด^ลิว
Kitv^lon	คิด^โลน
Kitv^lotv Taa^mbo	คิด^โล้ด^ทา^โบ
Kitv^tim	คิด^ทิม
Ko^lin^to	โค^ลิน^โท
Ko^lo^si	โค^โล^สี
Ko^naa^ni^yaa	โค^นา^นิ^ยา
Ko^ne^li^atc	โค^เน^ลิ^อัด
Ko^ni^yaa	โค^นิ^ยา
Ko^se^mbaa	โค^เซ^บา
Kolaa	โค^ลา
Kotc	โขด
Kumlaan	คูม^ลาน
Kun	คูน
Kuqan Li^taa^im	คู^ชัน^ลิ^ทา^อิม
Kuqi	คู^ชี
Kutv	คู้ด
Kutv^aa	คู้ด^อา
La'maaqh	หละม่าะ
Laa^aa^mi^yaa	ลา^อา^มิ^ยา
Laa^maa^taa^im Sofim	ลา^มา^ทา^อิม^โซ^ฟิม
Laafaa	ลา^ฟา
Laakaan	ลา^คาน
Laakem	ลา^เคม
Laakitv	ลา^คี้ด
Laamaa	ลา^มา
Laamaatv	ลา^ม้าด
Laamaatv Lehi	ลา^ม้าด^เล^ฮี
Laamam	ลา^มัม
Laamekv	ลา^เม้ก
Laami	ลา^มี
Laamotv	ลา^โม้ด
Laamotv Gi^le^aatc	ลา^โม้ด^กิ^เล^อาด
Laasen	ลา^เซน
Lakv^kum	ลัก^คูม
Lapv^bi^ndotc	ลับ^ปิ^โดด
Lapv^mbitc	ลับ^บีด
Lapv^saax^litv	ลับ^สา^ลี้ด
Le^haa^mbim	เล^หะ^บิม
Le^hum	เล^ฮูม
Le^maa^li^yaa	เล^มา^ลิ^ยา
Le^mbo Haamatv	เล^โบ^ฮา^มัด
Le^wi^aa^taan	เล^วี^อา^ทาน
Le^yi^um	เล^ยี^อูม
Lefaa	เล^ฟา
Lekaa	เล^คา
Lekaapv	เล^ค้าบ
Lekem	เล^เคม
Lesepv	เล^เซ้บ
Lesin	เล^ซิน
Lewi	เล^วี
Li^kaa^o^nie	ลิ^คา^โอ^เนีย
Li^mbe^tin	ลี^เบ^ทีน
Li^mbie	ลิ^เบีย
Li^ndie	ลิ^เดีย
Li^saa^daa	ลิ^สะ^ตา
Lifaatv	ลี^ฟ้าด
Likv^hi	ลิก^ฮี
Limmon	ลิม^โมน
Limmon Beletv	ลิม^โมน^เป^เล้ด
Linnaa	ลิน^นา
Lisiex	ลี^เสีย
Lo^Lu^haa^maa	โล^ลุ^หะ^มา
Logaa	โล^กา
Lomaa	โล^มา
Lotaan	โล^ทาน
Lotv	โล้ด
Lu^hitv	ลู^ฮี้ด
Lu^si^atc	ลู^สิ^อัด
Lugaa	ลู^กา
Lumaa	ลู^มา
Lute	ลู^เท
Lutv	ลู้ด
M'Yienc	เหมี่ยน
Maa^aa^saix	มะ^อา^ไส
Maa^aa^se^aa	มา^อา^เส^อา
Maa^aa^si^yaa	มา^อา^ซิ^ยา
Maa^haa^laa^le^en	มา^หะ^ลา^เล^เอน
Maa^haa^laa^len	มา^หะ^ลา^เลน
Maa^haa^laapv	มา^หะ^ล้าบ
Maa^haa^lai	มา^หะ^ไล
Maa^haa^latv	มา^หะ^ลัด
Maa^haa^naa^im	มา^หะ^นา^อิม
Maa^haa^ne Ndaan	มา^หะ^เน^ดาน
Maa^haa^si^otc	มา^หะ^ซิ^โอด
Maa^haa^wai	มา^หะ^ไว
Maa^li^yaa	มา^ลี^ยา
Maa^naa^sanx	มะ^นา^สัน
Maa^okc	มา^โอก
Maa^se^yaa	มา^เส^ยา
Maadi	มา^ตี
Maagokc	มา^โกก
Maaki	มา^คี
Maako	มา^โค
Maalaa	มา^ลา
Maalotv	มา^โล้ด
Maan^se^naa	มาน^เส^นา
Maasaan	มา^ซาน
Maataa	มา^ทา
Makv^he^lotv	มัก^เฮ^โล้ด
Makv^mbitc	มัก^บีด
Mamle	มัม^เล
Man^ki^yaa	มัน^คิ^ยา
Manlukv	มัน^ลุก
Matv^daa^taa	มัด^ตะ^ทา
Matv^taa^ni^yaa	มัด^ทา^นิ^ยา
Matv^ti^ti^yaa	มัด^ที^ทิ^ยา
Mbaa^aa^latv Mbe^e	บา^อา^ลัด^เบ^เอ
Mbaa^aa^se^yaa	บา^อา^เส^ยา
Mbaa^an Be^laa^sim	บา^อัน^เป^ลา^ซิม
Mbaa^an Haanan	บา^อัน^ฮา^นัน
Mbaa^an Hemon	บา^อัน^เฮ^โมน
Mbaa^an Mbelitv	บา^อัน^เบ^ลี้ด
Mbaa^an Me^on	บา^อัน^เม^โอน
Mbaa^an Qaa^li^qaa	บา^อัน^ชา^ลิ^ชา
Mbaa^an Se^mbupc	บา^อัน^เซ^บูบ
Mbaa^an Sefon	บา^อัน^เซ^โฟน
Mbaa^laa^ki^yaa	บา^ลา^คิ^ยา
Mbaa^laa^saa^tatv	บะ^ละ^สะ^ทัด
Mbaa^se^matv	บา^เส^มัด
Mbaa^ti^me^atc	บา^ทิ^เม^อัด
Mbaakotc	บา^โขด
Mbaalaakv	บา^ล้าก
Mbaalukv	บา^ลุก
Mbaamotv Mbaa^an	บา^โม้ด^บา^อัน
Mbaani	บา^นี
Mbaasaan	บา^ซาน
Mbakc^mbu^ki^yaa	บัก^บู^คิ^ยา
Mbatc^litv	บัด^ลี้ด
Mbatc^lutv	บัด^ลู้ด
Mbatc^se^mbaa	บัด^เซ^บา
Mbe^aa^lotv	เบ^อา^โล้ด
Mbe^e^lotv	เบ^เอ^โล้ด
Mbe^e^lotv Mbe^ne^yaa^aa^kan	เบ^เอ^โล้ด^เบ^เน^ยา^อา^คัน
Mbe^e^qe^mbaa	เบ^เอ^เช^บา
Mbe^en^se^mbun	เบ^เอน^เซ^บูน
Mbe^le^ki^yaa	เบ^เล^คิ^ยา
Mbe^ne Mbelaakv	เบ^เน^เบ^ล้าก
Mbe^ne Yaa^aa^kan	เบ^เน^ยา^อะ^คัน
Mbe^ni^nu	เบ^นิ^นู
Mbeke	เบ^เค
Mbelaa	เบ^ลา
Mbeletv	เบ^เล้ด
Mbeli	เบ^ลี
Mben Hinnom	เบน^ฮิน^โนม
Mben So^hetv	เบน^โซ^เฮ้ด
Mben^yaa^min	เบน^ยา^มิน
Mbeno	เบ^โน
Mbesekv	เบ^เซ้ก
Mbeso	เบ^โส
Mbetc Aa^laa^mbaa	เบด^อา^ลา^บา
Mbetc Aanaatv	เบด^อา^น้าด
Mbetc Aanotv	เบ^ทา^โน้ด
Mbetc Aawen	เบด^อา^เวน
Mbetc Batc^setv	เบด^ปัด^เซ้ด
Mbetc Be^o	เบด^เป^โอ
Mbetc Beletv	เบด^เป^เล้ด
Mbetc Emekv	เบด^เอ^เม้ก
Mbetc Gaa^nde	เบด^กา^เด
Mbetc Gin^gaan	เบด^กิน^กาน
Mbetc Haalam	เบด^ฮา^ลัม
Mbetc Hokv^laa	เบด^โฮ้ก^ลา
Mbetc Holon	เบด^โฮ^โลน
Mbetc Laafaa	เบด^ลา^ฟา
Mbetc Maan^kaa^mbotc	เบด^มาน^คา^โบด
Mbetc Mbaalaa	เบด^บา^ลา
Mbetc Ndaagon	เบด^ดา^โกน
Mbetc Nimlaa	เบด^นิม^ลา
Mbetc Qitv^taa	เบด^ชิด^ทา
Mbetc Saan	เบด^ซาน
Mbetc Se^aan	เบด^เซ^อาน
Mbetc Semetv	เบด^เซ^เม้ด
Mbetc Su	เบด^ซู
Mbetc Tapv^bu^waa	เบด^ทับ^ปู^วา
Mbetc Ye^si^motv	เบด^เย^ซิ^โม้ด
Mbi^le^am	บิ^เล^อัม
Mbi^ne^aa	บิ^เน^อา
Mbi^si^o^ti^yaa	บิ^ซิ^โอ^ทิ^ยา
Mbi^ti^nie	บิ^ที^เนีย
Mbi^ti^yaa	บิ^ทิ^ยา
Mbikc^taa	บิก^ทา
Mbikc^taa^naa	บิก^ทา^นา
Mbikc^taan	บิก^ทาน
Mbikc^wai	บิก^ไว
Mbin^haan	บิน^ฮาน
Mbinnui	บิน^นุย
Mbinsaan	บิน^ซาน
Mbosetv	โบ^เซ้ด
Mbukc^ki	บุก^คี
Mbukc^ki^yaa	บุก^คี^ยา
Mbunaa	บุ^นา
Mbusi	บุ^ซี
Me^hi	เม^หิ
Me^hi^ndaa	เม^หิ^ดา
Me^hu^maan	เม^หุ^มาน
Me^li^mbatc Kaa^ndetc	เม^ลิ^บัด^คา^เดด
Me^li^taa	เม^ลิ^ทา
Me^lo^nopv	เม^โล^โน้บ
Me^lo^notv	เม^โล^โน้ด
Me^ndi^de^le^nien	เม^ดิ^เต^เล^เนียน
Me^se^le^mi^yaa	เม^เซ^เล^มิ^ยา
Me^si^yaa	เม^สิ^ยา
Me^so^bo^de^mie	เม^โส^โป^เต^เมีย
Me^tu^se^laa	เม^ทู^เส^ลา
Melaa	เม^ลา
Melaapv	เม^ล้าบ
Melekv	เม^เล้ก
Meletv	เม^เล้ด
Melipv Mbaa^an	เม^ลิบ^บา^อัน
Melotv	เม^โล้ด
Memfitv	เมม^ฟิด
Mene	เม^เน
Mesaa	เม^ซา
Mesaakv	เม^ซ้าก
Mesekv	เม^เซ้ก
Mi^laa^lai	มิ^ลา^ไล
Mi^le^tatv	มิ^เล^ทัด
Mi^saa^en	มิ^ซา^เอน
Mi^ti^le^ni	มิ^ทิ^เล^นี
Mi^yaa^min	มิ^ยา^มิน
Migon	มิ^โกน
Mikaa	มี^คา
Mikaan	มี^คาน
Mikc^lotv	หมีก^โล้ด
Mikv^li	มิก^ลี
Mikv^lotv	มิก^โล้ด
Mikv^maatv	มิก^ม้าด
Mikv^me^tatv	มิก^เม^ทัด
Mikv^ndan En	มิก^ดัน^เอน
Mikv^ndan Gaatc	มิก^ดัน^กาด
Mikv^ndon	มิก^โดน
Mikv^ne^yaa	มิก^เน^ยา
Milaa	มิ^ลา
Miliem	มิ^เลียม
Min^yaa^min	มิน^ยา^มิน
Minkaa	มิน^คา
Minkom	มิน^โคม
Minlo	มิน^โล
Minmaa	มิน^มา
Misaa	มิ^ซา
Misaan	มิ^ซาน
Misie	มิ^เซีย
Mitv^le^fotv Maa^im	มิด^เล^โฟ้ด^มา^อิม
Mitv^ndin	มิด^ดีน
Mo^li^yaa	โม^ลิ^ยา
Mo^se^laa	โม^เส^ลา
Mo^se^lotv	โม^เส^โล้ด
Molekv	โม^เล้ก
Molitv	โม^ลิด
Mosaa	โม^ซา
Mose	โม^เซ
Musi	มู^ซี
Naa^haa^laan	นา^หะ^ลาน
Naa^haa^lai	นา^หะ^ไล
Naa^haa^li^en	นา^หะ^ลี^เอน
Naa^haa^lon	นา^หะ^โลน
Naa^haa^maa^ni	นา^หะ^มา^นี
Naa^hum	นา^ฮูม
Naafitv	นา^ฟิด
Naafotv Ndo^aa	นา^โฟ้ด^โด^อา
Naasi	นา^สี
Naason	นา^โซน
Naatan	นา^ทัน
Naayotv	นา^โย้ด
Ndaa^li^atc	ดา^ลิ^อัด
Ndaagon	ดา^โกน
Ndaalaa	ดา^ลา
Ndaankon	ดาน^โคน
Ndaawitv	ดา^วิด
Nde^li^laa	เด^ลิ^ลา
Nde^metv^li^atc	เด^เม้ด^ลิ^อัด
Ndi^le^an	ดิ^เล^อัน
Ndi^o^ni^si^atc	ดี^โอ^นิ^สิ^อัด
Ndikc^laa	ดิก^ลา
Ndin^haa^mbaa	ดิน^ฮา^บา
Ndisaan	ดี^ซาน
Ndison	ดี^โซน
Ndo^faa^kaa	โด^ฟะ^คา
Ndo^ndaa^waa^hu	โด^ดา^วา^หุ
Ndumaa	ดู^มา
Ne^aa^mbu^li	เน^อา^บุ^ลี
Ne^fi^simx	เน^ฟิ^สิม
Ne^haa^mi	เน^หะ^มี
Ne^hum	เน^ฮูม
Ne^li^yaa	เน^ลิ^ยา
Ne^mbu^saa^laa^ndaan	เน^บู^ซา^ละ^ดาน
Ne^si^yaa	เน^ซิ^ยา
Ne^taa^ni^yaa	เน^ทา^นิ^ยา
Nefekv	เน^เฟ้ก
Nefin	เน^ฟิน
Negan Saa^le^se	เน^กัน^ซา^เล^เซ
Negepc	เน^เกบ
Neko	เน^โค
Nesipv	เน^ซี้บ
Ni^kaa^no	นิ^คา^โน
Ni^ko^lau^ni^yom	นิ^โค^เลา^นิ^โยม
Ni^ko^mbu^li	นิ^โค^บุ^ลี
Ni^naa^we	นิ^นะ^เว
Nimlotv	นิม^โล้ด
Nisaanx	นิ^สาน
Nitv^lokv	นิด^โล้ก
No Aamon	โน^อา^โมน
Nogaa	โน^กา
Nopv	โน้บ
Notv	โน้ด
Noyaa	โน^ยา
O^mbetc E^ndom	โอ^เบด^เอ^โดม
O^ne^si^fo^latv	โอ^เน^สิ^โฟ^ลัด
O^ne^si^matv	โอ^เน^สิ^มัด
Ofi	โอ^ฟี
Okc	โอก
Olen	โอ^เลน
Omaa	โอ^มา
Omli	โอม^ลี
Onam	โอ^นัม
Onan	โอ^นัน
Ono	โอ^โน
Orqv?	เอ้าะ?
Osem	โอ^เซม
Peletc	เพ^เหลด
Peletv	เพ^เล้ด
Putv	พู้ด
Qelepv	เช^เล้บ
Qeme	เช^เม
Qetaa	เช^ทา
Qetaa Mbo^se^nai	เช^ทา^โบ^เซ^ไน
Qewaa	เช^วา
Qiqaa	ชี^ชา
Saa^do^ikc	สะ^โต^อิก
Saa^haa^laa^im	ซา^หะ^ลา^อิม
Saa^haa^su^maa	ซา^หะ^ซุ^มา
Saa^li^saa	ซา^ลิ^ซา
Saa^lo^me	สะ^โล^เม
Saa^lu^hen	ซา^ลุ^เฮน
Saa^maa^lie	สะ^มา^เลีย
Saa^mbakc^taa^ni	สะ^บัก^ทา^นี
Saa^me^naa	สะ^เม^นา
Saa^taa^kitv	สะ^ทา^คิด
Saa^te^faa^natv	สะ^เท^ฟา^นัด
Saa^te^fen	สะ^เท^เฟน
Saa^waa^saa	ซา^วะ^ซา
Saaben	สะ^เปน
Saadaan	ซา^ตาน
Saafaam	ซา^ฟาม
Saafaan	ซา^ฟาน
Saafatv	ซา^ฟัด
Saagi	ซา^กี
Saalaa	ซา^ลา
Saalaai	ซา^ลาย
Saalem	ซา^เลม
Saalon	ซา^โลน
Saamaa	ซา^มา
Saami	ซา^มี
Saanx^se^kim	สาน^เส^คิม
Saasakv	ซา^ซัก
Saax^fe^naatv Baa^ne^aa	สา^เฟ^น้าด^ปา^เน^อา
Saen^maa^ne^se	แซน^มา^เน^เส
Saibatc	ไซ^ปัด
Sailatv	ไซ^ลัด
Sailin	ไซ^ลีน
Sakc^kaa^li^yaa	สะ^คา^ลิ^ยา
Sakc^kutv	สัก^คุด
Sam^mu^waa	ซัม^มุ^วา
Sammaa	ซัม^มา
Sammai	ซัม^ไม
Sammotv	ซัม^โม้ด
Samx^gaa Ne^mbo	สัม^กา^เน^โบ
Sanlum	ซัน^ลูม
Saulo	เซา^โล
Se^aa^laa	เซ^อา^ลา
Se^aa^li^yaa	เซ^อา^ลิ^ยา
Se^an^ti^en	เซ^อัน^ทิ^เอน
Se^epc	เส^เอบ
Se^faa^laatv	เส^ฟา^ล้าด
Se^faa^taa	เส^ฟา^ทา
Se^faa^ti^yaa	เซ^ฟา^ทิ^ยา
Se^faan^waa^im	เส^ฟาน^วา^อิม
Se^fan^yaa	เส^ฟัน^ยา
Se^haa^li^yaa	เซ^หะ^ลี^ยา
Se^i	เส^อี
Se^ji^atc	เส^จี^อัด
Se^kaa^ni^yaa	เซ^คา^นิ^ยา
Se^kun^ndatc	เส^คุน^ดัด
Se^laa^saa	เซ^ลา^ซา
Se^lai^aa	เส^ไล^อา
Se^le^laa	เส^เล^ลา
Se^le^mi^yaa	เซ^เล^มิ^ยา
Se^le^ndaa	เส^เล^ดา
Se^lo^fe^hatc	เส^โล^เฟ^หัด
Se^lu^mi^en	เซ^ลู^มิ^เอน
Se^lupv^mbaa^mben	เส^ลุบ^บา^เบน
Se^maa^laa^im	เส^มา^ลา^อิม
Se^maa^li^yaa	เซ^มา^ลิ^ยา
Se^mai^aa	เซ^ไม^อา
Se^mbaa	เส^บา
Se^mbaa^ni^yaa	เซ^บา^นิ^ยา
Se^mbaam	เส^บาม
Se^mbatc	เซ^บัด
Se^mbo^im	เส^โบ^อิม
Se^mbo^yim	เส^โบ^ยิม
Se^mbu^lun	เส^บู^ลุน
Se^mbun	เส^บุน
Se^me^in	เส^เม^อิน
Se^mi^laa^motv	เซ^มิ^ลา^โม้ด
Se^mi^ndaa	เซ^มิ^ดา
Se^mi^nitv	เซ^มิ^นิด
Se^naa^aa	เส^นา^อา
Se^ndatc	เส^ดัด
Se^nde^ki^yaa	เส^เด^คี^ยา
Se^o^lim	เส^โอ^ลิม
Sefaa	เส^ฟา
Sefaam	เซ^ฟาม
Sefatv	เส^ฟัด
Sefi	เซ^ฟี
Sefo	เส^โฟ
Sefon	เส^โฟน
Segupc	เส^กุบ
Seke	เส^เค
Sekem	เซ^เคม
Sekenx	เซ^เขน
Seku	เส^คู
Selaa	เซ^ลา
Selaa Ham^maa^le^kotv	เซ^ลา^ฮัม^มา^เล^โค้ด
Selekv	เส^เล้ก
Selepv	เซ^เล้บ
Seletc	เซ^เหลด
Seletv	เส^เล้ด
Seli	เส^ลี
Selo	เส^โล
Selukv	เส^ลุก
Semaa	เซ^มา
Seme	เส^เม
Semetv	เซ^เม้ด
Senaatv	เส^น้าด
Senan	เส^นัน
Sene	เส^เน
Seni	เส^นี
Sesan	เซ^ซัน
Setaam	เส^ทาม
Setaan	เส^ทาน
Setu	เส^ทู
Sewaa	เส^วา
Si^aa	สี^อา
Si^aa^haa	สี^อา^ฮา
Si^e^ne	สิ^เอ^เน
Si^fi^yon	สิ^ฟิ^โยน
Si^gi^o^notv	ซิ^กิ^โอ^โน้ด
Si^haqc	สี^หะ
Si^honx	สิ^โหน
Si^hox	ซิ^โห
Si^hox Lipv^naatv	ซิ^โห^ลิบ^น้าด
Si^laa^aa	สี^ลา^อา
Si^li^orn	สี^ลี^ออน
Si^lo^am	สี^โล^อัม
Si^mbaa	ซิ^บา
Si^mbe^on	สิ^เบ^โอน
Si^mbi^yaa	สิ^บี^ยา
Si^mbie	สิ^เบีย
Si^me^aa	ซิ^เม^อา
Si^me^am	ซิ^เม^อัม
Si^me^atc	ซิ^เม^อัด
Si^me^on	สิ^เม^โอน
Si^on	สิ^โอน
Si^saa^aa	ซิ^ซา^อา
Si^saa^li^yaa Fi^lipv^poi	ซี^ซา^ลี^ยา ฟี^ลิบ^พอย
Si^saa^mai	สิ^สะ^ไม
Si^si^li	ซี^ซิ^ลี
Sifaa	สิ^ฟา
Sifi	ซิ^ฟี
Sifon	สิ^โฟน
Sikaa	สิ^คา
Sikc^laakv	สิก^ล้าก
Sikc^li	สิก^ลี
Sikv^gaa^yon	ซิก^กา^โยน
Sikv^ke^lon	ซิก^เค^โลน
Silaa	ซี^ลา
Silie	ซี^เลีย
Silie Fi^ni^sie	ซี^เลีย^ฟี^นิ^เซีย
Silo	ซี^โล
Simlaatv	ซิม^ล้าด
Simli	ซิม^ลี
Simlon	ซิม^โลน
Simlon Melon	ซิม^โลน^เม^โลน
Simon	ซี^โมน
Sin^hi	ซิน^หิ
Sinaa	ซี^นา
Sini	สี^นี
Sinlem	ซิน^เลม
Sinsaa	ซิน^ซา
Sinx^ti^ke	สิน^ทิ^เค
Sisaa	ซี^ซา
Sisakv	ซิ^ซัก
Sitie	สิ^เทีย
Siwan	สิ^วัน
Siyo	สิ^โย
So Hungh	โส ฮู่ง
So^aa	โส^อา
So^an	โส^อัน
So^baa^te	โส^ปา^เท
So^fe^letv	โส^เฟ^เล้ด
So^haa	โส^ฮา
So^haax	โส^หา
So^hetc	โส^เหด
So^mbaa	โส^บา
So^mbe^mbaa	โส^เบ^บา
So^ndi	โส^ดี
So^ndom	โส^โดม
Sofaa	โส^ฟา
Sofaakv	โซ^ฟ้าก
Sofai	โส^ไฟ
Sofim	โส^ฟิม
Soko	โส^โค
Solaa	โส^ลา
Solekv	โส^เล้ก
Sotai	โส^ไท
Su^aa	สุ^อา
Su^ki^im	สุ^คี^อิม
Su^sanx^naa	สุ^สัน^นา
Sufaa	สุ^ฟา
Sukaa	สุ^คา
Sukc^kotv	สุก^โค้ด
Sukc^kotv Mbenotv	สุก^โค้ด^เบ^โน้ด
Sumatv	ซู^มัด
Sunem	ซู^เนม
Supc	สูบ
Supc^aa	สุบ^อา
Susaax	สุ^สา
Susi	สุ^สี
Suwaa	ซู^วา
Sux^li^en	สู^ลิ^เอน
Sux^li^satv^ndai	สู^ลิ^ซัด^ได
Taa^aa^natv Silo	ทา^อา^นัด^ซิ^โล
Taa^laa^laa	ทา^ละ^ลา
Taa^li^taa^ku^mi	ทา^ลิ^ทา^คู^มิ
Taa^mbi^taa	ทา^บิ^ทา
Taalie	ทา^เลีย
Taamaa	ทา^มา
Taansitv	ทาน^ซิด
Taasatv	ทา^ซัด
Taigitc	ไท^กิด
Tailaqv	ไท^ละ
Tammutv	ทัม^มุด
Tan^hu^metv	ทัน^หุ^เม้ด
Tanmai	ทัน^ไม
Tanmon	ทัน^โมน
Te^mbaa^li^yaa	เท^บา^ลิ^ยา
Te^saa^lo^ni^gaa	เท^สะ^โล^นิ^กา
Te^ti^atc	เท^ทิ^อัด
Telaa	เท^ลา
Teletv	เท^เล้ด
Temaa	เท^มา
Temaan	เท^มาน
Ten Aa^mbipc	เทน^อา^บิบ
Ten Haanx^saa	เทน^หาน^ซา
Ten Melaa	เทน^เม^ลา
Ti^ki^gatc	ที^คิ^กัด
Ti^laa^haa^kaa	ที^ละ^หะ^คา
Ti^laa^haa^naa	ที^ละ^หะ^นา
Ti^laa^saa	ที^ละ^ซา
Ti^laa^tai	ทิ^ลา^ไท
Ti^li^yaa	ทิ^ลี^ยา
Ti^mbe^li^atc	ทิ^เบ^ลิ^อัด
Ti^mbe^lietv	ทิ^เบ^เลี้ยด
Ti^me^atc	ทิ^เม^อัด
Ti^mo^tai	ทิ^โม^ไท
Ti^ndaan	ทิ^ดาน
Ti^ti^atc Yu^saa^tatv	ทิ^ทิ^อัด^ยุ^สะ^ทัด
Ti^yaa^ti^laa	ทิ^ยา^ทิ^ลา
Tidatc	ทิ^ตัด
Tikc^waa	ทิก^วา
Tikv^latv Bi^le^se	ทิก^ลัด^ปิ^เล^เส
Tilaatv	ทิ^ล้าด
Tilon	ทิ^โลน
Timnaa	ทิม^นา
Timnaatv Heletv	ทิม^น้าด^เฮ^เล้ด
Timnaatv Selaa	ทิม^น้าด^เส^ลา
Timon	ทิ^โมน
Tisai	ทิ^ไซ
Tofetv	โท^เฟ้ด
Tohu	โท^หุ
Token	โท^เคน
Tolaa	โท^ลา
Tolatv	โท^ลัด
Topv Aa^ndo^ni^yaa	โท้บ^อา^โด^นิ^ยา
Totv^mbu^li	โท้ด^บุ^ลี
Tu^mban	ทู^บัน
Tu^mban Kaa^in	ทู^บัน^คา^อิน
Tu^ndaatc	ทุ^ดาด
Tummim	ทุม^มิม
U^li^aa	อุ^ลี^อา
U^li^en	อุ^ลี^เอน
U^li^yaa	อุ^ลี^ยา
Ufaatv	อุ^ฟ้าด
Ulaam	อุ^ลาม
Uli	อุ^ลี
Ulim	อุ^ลิม
Unlaa	อุน^ลา
Unni	อุน^นี
Usaan	อุ^ซาน
Usai	อุ^ไซ
Utai	อุ^ไท
Utc	อูด
Utc^saa	อุด^ซา
Utc^sen Qe^e^laa	อุด^เซน^เช^เอ^ลา
Utc^sen Se^e^laa	อุด^เซน^เซ^เอ^ลา
Utc^si	อุด^ซี
Utc^si^en	อุด^ซี^เอน
Utc^si^yaa	อุด^ซี^ยา
Waa^ni^yaa	วา^นิ^ยา
Wopv^si	โว้บ^สี
Yaa^aa^si^en	ยา^อา^ซี^เอน
Yaa^aa^su	ยา^อา^สุ
Yaa^laa^haa	ยา^ละ^ฮา
Yaa^mbetc Gi^le^aatc	ยา^เบด^กิ^เล^อาด
Yaafetv	ยา^เฟ้ด
Yaafie	ยา^เฟีย
Yaagorpc	ยา^กอบ
Yaagun	ยา^กูน
Yaakaan	ยา^คาน
Yaakim	ยา^คิม
Yaakin	ยา^คีน
Yaakopv	ยา^โค้บ
Yaalaa	ยา^ลา
Yaalaam	ยา^ลาม
Yaaletv	ยา^เล้ด
Yaalipv	ยา^ลี้บ
Yaalon	ยา^โลน
Yaamai	ยา^ไม
Yaamin	ยา^มีน
Yaanai	ยา^ไน
Yaanmutv	ยาน^มู้ด
Yaasaa	ยา^ซา
Yaase	ยา^เซ
Yaasitv	ยา^ซี้ด
Yaasupv	ยา^ซู้บ
Yaawaan	ยา^วาน
Yamlekv	ยัม^เล้ก
Yannetv	ยัน^เน้ด
Ye^ho^waa Nitv^si	เย^โฮ^วา นิด^ซี
Ye^ho^waa Yi^le	เย^โฮ^วา ยี^เล
Ye^ho^yaa^kin	เย^โฮ^ยา^คีน
Ye^hutv	เย^ฮู้ด
Ye^kaa^mi^yaa	เย^คา^มิ^ยา
Ye^ko^ni^yaa	เย^โค^นี^ยา
Ye^mbe^le^ki^yaa	เย^เบ^เล^คี^ยา
Ye^ndi^ndi^yaa	เย^ดี^ดิ^ยา
Ye^ndu^tun	เย^ดู^ทูน
Ye^si^mi^en	เย^สิ^มี^เอน
Ye^si^mon	เย^ซิ^โมน
Ye^si^sai	เย^ซิ^ไซ
Ye^so^haa^yaa	เย^โซ^ฮา^ยา
Ye^su^aa	เย^ซู^อา
Ye^utc	เย^อูด
Ye^utc^e	เย^อุด^เอ
Yelaa	เย^ลา
Yeletv	เย^เล้ด
Yelupv Mbaa^an	เย^ลุบ^บา^อัน
Yen^ne^saa^letv	เยน^เน^ซา^เล้ด
Yepv^taa	เยี้ยบ^ทา
Yese	เย^เซ
Yesu	เย^ซู
Yete	เย^เท
Yetetv	เย^เท้ด
Yeto	เย^โท
Yetu	เย^ทู
Yilon	ยิ^โลน
Yitv^le^en	ยิด^เล^เอน
Yitv^saa^laa^yaa	ยิด^สะ^ลา^ยา
Yiutai	ยิว^ไท
Yo^en	โย^เอน
Yo^laa^ke^am	โย^ละ^เค^อัม
Yo^saa^wi^yaa	โย^ซา^วิ^ยา
Yo^si^fi^yaa	โย^สิ^ฟี^ยา
Yo^si^mbi^yaa	โย^ซิ^บี^ยา
Yo^si^yaa	โย^สิ^ยา
Yokim	โย^คิม
Yolai	โย^ไล
Yolam	โย^ลัม
Yonaa	โย^นา
Yopv	โย้บ
Yoqepv Mbatc^qe^mbetc	โย^เช้บ^บัด^เช^เบด
Yosepv	โย^เซ้บ
Yotaam	โย^ทาม
Yu^saa^tatv	ยุ^สะ^ทัด
Yu^ti^gatc	ยู^ทิ^กัด
Ze^e^letv Saa^haax	เฒ^เอ^เล้ด^ซา^หา
Zefi	เฒ^ฟี
Zelaa	เฒ^ลา
Zeletv	เฒ^เล้ด
Zinaa	ฒี^นา
Zisaa	ฒี^ซา
a'ngunc	อะหงุ่น
aa^lam^naa^haa^laa^im	อา^ลัม^นา^หะ^ลา^อิม
aa^lon^mbaa^kutv	อา^โลน^บา^คู้ด
aah	อ้า
aah loc	อ้าโหล่
aqc mangc	อะหมั่ง
biuih	ปยุ้ย
biuih biuih	ปยุ้ยปยุ้ย
camv-camv	ธั้มๆ
da'faanh	ตะฟ่าน
da'hmz	ตะฮม์
ding ding	ตีง ตีง
dungx	ตู๋ง
efotv	เอ^โฟ้ด
Faa^li^si	ฟา^ลิ^สี
fu'jueiv	ฝุเจว๊ย
ga'hlen	กะเฮลน
ga'naaiv-mbeix mbeix	กะน้าย-เบ๋ย เบ๋ย
ga'nyiec	กะเหญี่ย
gilo	กี^โล
gu'nguaaic	กู้ หงว่าย
gu'nguaaz	กู้งว์า
gu'nyuoz	กะญั์ว
guen	เกวน
guengx	เกว๋ง
guenx	เกว๋น
guetv	เกว๊ด
guinh	กวิ้น
guinh guinh	กวิ้นๆ
haaix	หาย
hieh	เฮยี่ย
hienv	เฮยี้ยน
hienx	เหฮยียน
hietc	เหฮยียด
hietv	เฮยี้ยด
hiou	โฮยว
hiun	ฮยุน
hlieqv-gaaz gaaz	เฮลียะ-ก์า ก์า
hlieqv-kou	เฮลียะ-โคว
hlieqv-kou kou	เฮลียะ-โคว โคว
hmz	ฮม์
hnyouv	เฮญี้ยว
hui	ฮวุย
hui-baeqc	ฮวุย-แปะ
huin	ฮวิน
huing	ฮวีง
huingx	หฮวีง
huon	ฮววน
huonh	ฮว่น
huonh huonh	ฮว่วนๆ
huotv	ฮว้วด
huov-jeix	ฮวั้ว-เจ๋ย
husopc	หุ^โสบ
jatv	จ๊ัด
jiem-kuing	เจียม-ควีง
ka'ndau	ขะเดา
kou kou	โคว โคว
kouv	โค้ว
kouv kouv	โค้วๆ
kuing	ควีง
kuinx	ขวิน
la'bieiv	หละเปย๊ย
la'guaih	หละไกว้
la'kuqv	หละคุ
la'maah	ล่าม่า
la'ngopv	หละงบ
laa^maa^saa^mbakc^taa^ni	ลา^มา^ซา^บัก^ทา^นี
laatc laatc	หลาด หลาด
loh!	โล่ะ!
m'nqorngv	มฆ้อง
Maa^natv^se	มะ^นัด^เส
maah	ม่าะ
maaz-li	มา^ลี
mbaali	บา^ลี
piatv	พยัด
mbiuic	บยุ่ย
mbiungc	บยู่ง
mbiungc-nziaaux	บยู่ง-หฑยาว
mbiungc-suiv	บยู่ง-ซุ้ย
mbu'ndongx	บุด๋ง
mbu'ziex	บัวะ เหฒีย
mi'aqv	หมี่ อ๊ะ
minaa	มี^นา
morc morc	หม่อ หม่อ
mukv	มุก
mv	ม้
mv baac	มป่า
mv bei	มเปย
naah daangc	หน้าต่าง
namv^man	น้ำมัน
ndenz-ndenz	เด์นๆ
ndiangx-gaaz gaaz	เดี๋ยง-ก์า ก์า
nernh	เน่น
niaa	นีอา
nie-ha'louh	เนีย-หะโล่ว
ninh ninh	นิ่น นิ่น
njoux	เหฌียว
norm-norm	นอมๆ
nquekc	เหฆวก
nquin	ฆวิน
nyei	เญย
nza'hmien	หฑะเฮมียน
nzaangc	หฑั่ง
oeix	โอ๋ย
pa'li pa'laaix	พะลี พะหลาย
piuv	พยู้
Saa^ndu^si	สะ^ดู^สี
saah	ซ่าะ
saev-saev	แซ้ๆ
se gorngv	สี ก๊อง
se^aan^yaa^supv	เซ^อาน^ยา^ซู้บ
Se^kaa^kaa	เส^คะ^คา
Se^kaa^li^yaa	เส^คา^ลิ^ยา
Se^laa^fim	เส^ลา^ฟิม
Se^laa^hi^yaa	เส^ลา^หิ^ยา
Se^lu^waa	เส^ลุ^วา
Se^lu^yaa	เส^ลุ^ยา
Se^maa^ki^yaa	เส^มา^คิ^ยา
Se^mbaa^ndi^yaa	เส^บา^ดิ^ยา
Se^mbi^naa	เส^บิ^นา
Se^mbi^ndaa	เส^บิ^ดา
se^me^nitv	เซ^เม^นิด
Se^mi^laa	เส^มิ^ลา
si sietc	สี เสียด
si^me^i	ซิ^เม^อี
si^ndaa	สี^ดา
Si^se^laa	สิ^เส^ลา
So^saa^te^netv	โส^สะ^เท^เน้ด
So^si^baa^te	โส^สิ^ปา^เท
uix	หวุย
weqv	เว่ะ
wuom	ววม
wuoqc	หวัวะ
wuov	วั้ว
yieqv	เยียะ
yieqv-yieqv	เยียะๆ
za'eix	หฒะเอ๋ย
za'gengh	หฒะเก้ง
zaangc	หฒั่ง
zueiz	เฒว์ย
zuqc zuqc	หฒุ หฒุ
# new additions
ziangh	เฒี่ยง
Gi^hon	กี^โฮน
Mbaa^mbi^lon	บา^บี^โลน
Le^hox^mbotc^i	เล^โห^โบด^อี
Sai^ndorn	ไซ^ดอน
Yokv^taan	โย้ก^ทาน
He^mbo^lon	เฮ^โบ^โลน
ziouc	ฯฒฯ
E^fo^lon	เอ^โฟ^โลน
mba'zorng-hiun	บะฒอง-ฮยุน
Yokv^saan	โย้ก^ซาน
Ne^mbaa^yotv	เน^บา^โย้ด
E^ndom	เอ^โดม
Le^hox^mbotc	เล^โห^โบด
Hetv^lon	เฮ้ด^โลน
Etc^mbon	เอด^โบน
Sanx^mon	สัน^โมน
Ye^li^otc	เย^ลี^โอด
Haau^wotv Jaa^i	ฮาว^โว้ด^จา^อี
Maa^on	มา^โอน
Apc^saa^lom	อับ^ซา^โลม
Aan^ndon	อาน^โดน
Etc^taa^on	เอด^ทา^โอน
Etc^ton	เอด^โทน
Otc^ni^en	โอด^นี^เอน
Siqv^mon	ซิ^โมน
Me^laa^yotv	เม^ลา^โย้ด
Saax^ndokc	สา^โดก
Aa^naa^totv	อา^นา^โท้ด
Yokv^me^am	โย้ก^เม^อัม
Ai^yaa^lon	ไอ^ยา^โลน
Apc^ndon	อับ^โดน
Le^hopc	เล^โหบ
Ke^nde^motv	เค^เด^โม้ด
Hetv^mbon	เฮ้ด^โบน
Ye^li^motv	เย^ลี^โม้ด
Ye^le^motv	เย^เล^โม้ด
Saa^an^mbon	ซา^อัน^โบน
aa^laa^motv	อา^ลา^โม้ด
saa^lom	ซา^โลม
Se^lo^motv	เซ^โล^โม้ด
Yotv^mbe^kaa^saa	โย้ด^เบ^คา^ซา
Otc^ni	โอด^นี
ndaa^likv	ดา^ลี้ก
Su^kotv	ซู^โค้ด
Saa^lo^mon	ซา^โล^โมน
Kitc^lon	ขิด^โลน
Atc^ndotc	อัด^โดด
Me^sin^le^motv	เม^ซิน^เล^โม้ด
Tokv^haatc	โท้ก^หาด
se gorngv ndaam	เซ ก๊อง ดาม
se gorngv deix	เซ ก๊อง เต๋ย
se gorngv waac	เซ ก๊อง หว่า
Naaiv se gorngv	น้าย เซ ก๊อง
se gorngv ndo	เซ ก๊อง โด
se gorngv-baeqc	เซ ก๊อง-แปะ
Aa^lupv^mbotc	อา^ลุบ^โบด
sou se gorngv	โซว เซ ก๊อง
Ke^motv	เค^โม้ด
Leson	เล^โซน
Aa^mbi^qaa^lom	อา^บี^ชา^โลม
Tapv^lim^mon	ทับ^ลิม^โมน
Gipc^mbe^ton	กิบ^เบ^โทน
Mbong-ningv	บง-นี้ง
Naa^mbotc	นา^โบด
Ndoqv-hlen	โด๊ะ-เฮลน
Fi^le^mon	ฟี^เล^โมน
Hopv^ni	โฮ้บ^นี
I^kaa^mbotc	อี^คา^โบด
Sipc^motv	สิบ^โม้ด
Atc^ke^lon	อัด^เค^โลน
Aa^motv	อา^โม้ด
Yaasonx	ยา^โสน
Atc^sotc	อัด^โสด
Ki^otc	คี^โอด
jopv-nyeic	จ๊บ-เหญ่ย
Lukv	ลู้ก
Haa^mon	ฮา^โมน
Gutc^go^ndaa	กุด^โก^ดา
Yotv^mbaa^taa	โย้ด^บา^ทา
Ndaan^fon	ดาน^โฟน
ndu^gong	ดู^โกง
Hen^mbon	เฮน^โบน
Ndi^mbon	ดี^โบน
ndiangx-ding ding	เดี๋ยง-ตีง ตีง
E^saanx^hatv^ndon	เอ^สาน^ฮัด^โดน
Maa^ndukc	มา^ดูก
Ekc^lon	เอก^โลน
Opc^faa^laa	โอบ^ฟา^ลา
Kaa^mon	คา^โมน
Saax^fon	สา^โฟน
Yokv^mbe^haa	โย้ก^เบ^ฮา
An^naa^totv	อัน^นา^โท้ด
Holon	โฮ^โลน
Mbetc^me^on	เบด^เม^โอน
Aai^non	อาย^โนน
Gon^go^taa	โกน^โก^ทา
Se^mbe^ndi	เส^เบ^ดี
Mbe^he^motv	เบ^เฮ^โม้ด
Maa^ndon	มา^โดน
Melom	เม^โลม
Laa^saa^lon	ลา^ซา^โลน
Yokv^ne^am	โย้ก^เน^อัม
Atc^mon	อัด^โมน
Hinnom	ฮิน^โนม
Hetv^mon	เฮ้ด^โมน
Honmaa	โฮน^มา
Le^mbaa^otc	เล^บา^โอด
Yotv^te^en	โย้ด^เท^เอน
Mbotc^kaatv	โบด^ค้าด
Kapv^mbon	คับ^โบน
Yokv^nde^am	โย้ก^เด^อัม
Hokv^laa	โฮ้ก^ลา
Naafotv	นา^โฟ้ด
Opc^ni	โอบ^นี
Mbetc^le^mbaa^otc	เบด^เล^บา^โอด
Han^naa^ton	ฮัน^นา^โทน
Siyon	ซี^โยน
E^mbon	เอ^โบน
Me Yaankon	เม^ยาน^โคน
An^mon	อัน^โมน
Ham^motv^ndo	ฮัม^โม้ด^โด
En^te^kon	เอน^เท^โคน
Lakv^kon	ลัก^โคน
Hatc^se^naa^aa	หัด^เส^นา^อา
Me^le^motv	เม^เล^โม้ด
Mbe^so^ndai^aa	เบ^โส^ได^อา
Yaa^ndon	ยา^โดน
Kon Ho^se	โคน^โฮ^เซ
Atc^mbukc	อัด^บูก
Tapv^mbaa^otc	ทับ^บา^โอด
Paa^ndon	พา^โดน
Mbakc^mbukc	บัก^บูก
Atc^ndon	อัด^โดน
Gin^ne^ton	กิน^เน^โทน
Aa^mokv	อา^โม้ก
Helon	เฮ^โลน
O^mbotc	โอ^โบด
Mbaa^motv	บา^โม้ด
Bu^non	ปู^โนน
Qitv^lon	ชิด^โลน
Yokv^li	โย้ก^ลี
Kotv^mbi	โค้ด^บี
Mbe^on	เบ^โอน
Aa^mbatc^ndon	อา^บัด^โดน
Maalon	มา^โลน
Si^ndon	ซี^โดน
Si^li^on	ซี^ลี^โอน
Hikv^gai^on	ฮี้ก^ไก^โอน
Yokv^te^en	โย้ก^เท^เอน
Yotv^mbaa	โย้ด^บา
Mbitv^lon	บิ๊ด^โลน
Naakon	นา^โคน
Pi^laa^ton	พี^ลา^โทน
Aa^mbi^yan^mbon	อา^บี^ยัน^โบน
Daatim Hotc^qi	ตา^ทิม^โหด^ชี
On Zingh	โอน ฒี่ง
Otc^napv^baa	โอด^นับ^ปา
Maa^laa^yotv	มา^ลา^โย้ด
Qi^me^on	ชี^เม^โอน
Otc^naa^baa	โอด^นา^ปา
saa^fon	ซา^โฟน
