a'ngunc	ອະຫງຸ່ນ
aah	ອ້າ
hmz	ຮມ໌
wuom	ວວມ
#wuov	#ອັ້ວ
nernh	ເນິ່ນ
haaix	ຫາຍ
maah	ມ່າະ
saah	ຊ່າະ
dungx	ຕູ໋ງ
oeix	ໂອ໋ຍ
mbiuic	ບຢຸ່ຍ
biuih	ປຢຸ້ຍ
orqv	ເອ໊າະ
m'nqorngv	ມອກ໊ອງ
se gorngv	ເຊ ກ໊ອງ
fu'jueiv	ຝຸຈ໊ວຍ
wuoqc	ວົວະ
#mbu'ziex	#ບົວະ ເຕສຍ
laeqh	ແລ່ະ
#niaa	#ນີອາ
weqv	ເວ່ະ
mienc	ມຢ່ຽນ
Lewi	ເລ^ວີ
Aa^mben Mbetc Maa^aa^kaa	ອາ^ເບນ^ເບດ^ມາ^ອະ^ຄາ
Aa^mbi^hutv	ອາ^ບີ^ຮູດ
Aa^mbi^tupv	ອາ^ບີ^ທູບ
Aa^mbipc	ອາ^ບີບ
Aa^ndin	ອາ^ດີນ
Aa^haa^laa	ອາ^ຫະ^ລາ
Aa^haa^su^e^latv	ອາ^ຫະ^ສຸ^ເອ^ລັດ
Aa^haa^waa	ອາ^ຫະ^ວາ
Aa^hi	ອາ^ຫິ
Aa^hi^aa	ອາ^ຫິ^ອາ
Aa^hi^hutv	ອາ^ຫິ^ຮູດ
Aa^hi^kam	ອາ^ຫິ^ຄຳ
Aa^hi^laa	ອາ^ຫິ^ລາ
Aa^hi^lam	ອາ^ຫິ^ລຳ
Aa^hi^lutv	ອາ^ຫິ^ລູດ
Aa^hi^maa^atc	ອາ^ຫິ^ມາ^ອັດ
Aa^hi^maan	ອາ^ຫິ^ມານ
Aa^hi^me^lekv	ອາ^ຫິ^ເມ^ເລກ
Aa^hi^motv	ອາ^ຫິ^ໂມດ
Aa^hi^naa^ndapc	ອາ^ຫິ^ນາ^ດັບ
Aa^hi^no^am	ອາ^ຫິ^ໂນ^ອຳ
Aa^hi^qaa	ອາ^ຫິ^ທຈາ
Aa^hi^qaa^haa	ອາ^ຫິ^ທຈາ^ຮາ
Aa^hi^saa^makv	ອາ^ຫິ^ສະ^ມັກ
Aa^hi^to^fen	ອາ^ຫິ^ໂທ^ເຟນ
Aa^hi^tupv	ອາ^ຫິ^ທູບ
Aa^hi^yaa	ອາ^ຫິ^ຢາ
Aa^hi^yam	ອາ^ຫິ^ຢຳ
Aa^hi^yan	ອາ^ຫິ^ຢັນ
Aa^hi^ye^se	ອາ^ຫິ^ເຢ^ເຊ
Aa^hi^yo	ອາ^ຫິ^ໂຢ
Aa^hu^mai	ອາ^ຫຸ^ໄມ
Aa^laa^mbie	ອາ^ລະ^ເບຍ
Aa^laa^maa^getc^ndon	ອາ^ລະ^ມາ^ເກດ^ໂດນ
Aa^lam^maa^aa^kaa	ອາ^ລຳ^ມາ^ອະ^ຄາ
aa^lam^naa^haa^laa^im	ອາ^ລຳ^ນາ^ຫະ^ລາ^ອິມ
Aalam So^mbaa	ອາ^ລຳ^ໂຊ^ບາ
Aa^li^maa^tie	ອາ^ລິ^ມາ^ເທຍ
Aa^lon^mbaa^kutv	ອາ^ໂລນ^ບາ^ຄູດ
Aalutv	ອາ^ລູດ
Aa^maa^li^yaa	ອາ^ມາ^ລິ^ຢາ
Aa^maa^si^yaa	ອາ^ມາ^ຊິ^ຢາ
Aa^naa^haa^laatv	ອາ^ນາ^ຫະ^ລາດ
Aa^nupv	ອາ^ນູບ
Aa^bor^li^yon	ອາ^ປໍ^ລິ^ໂຢນ
Aa^saa^li^yaa	ອາ^ຊາ^ລິ^ຢາ
Aa^saa^si^yaa	ອາ^ຊາ^ຊິ^ຢາ
Aa^si^en	ອາ^ສິ^ເອນ
Aa^si^maa	ອາ^ຊິ^ມາ
Aa^su^mbaa	ອາ^ຊຸ^ບາ
Aa^taa^li^yaa	ອາ^ທາ^ລິ^ຢາ
Aaten	ອະ^ເທນ
Aawitv	ອາ^ວີດ
Aan^taa^se^sitv	ອານ^ທາ^ເຊ^ຊີດ
Akc^kupc	ອັກ^ຂູບ
Akc^sipv	ອັກ^ຊີບ
Am^fi^mbu^li	ອຳ^ຟີ^ບຸ^ລີ
Am^mi^hutv	ອຳ^ມີ^ຮູັດ
Am^mi^saa^mbaatc	ອຳ^ມີ^ຊະ^ບາດ
Am^paa^li^aa^tatv	ອຳ^ຜະ^ລີ^ອາ^ທັດ
An^ndo^ni^katv	ອັນ^ໂດ^ນິ^ຄັດ
An^ti^baa^di	ອັນ^ທິ^ປາ^ຕີ
An^ti^baatc	ອັນ^ທິ^ປາດ
Atc^laa^mitv^ti^yum	ອັດ^ລາ^ມິດ^ທິ^ຢຸມ
Atc^taa^li^yaa	ອັດ^ທາ^ລິ^ຢາ
Mbaa^an^Mbelitv	ບາ^ອັນ^ເບ^ລີ້ດ
Mbaa^an Qaa^li^qaa	ບາ^ອັນ^ທຈາ^ລິ^ທຈາ
Mbaa^an^se^mbupc	ບາ^ອັນ^ເຊ^ບູບ
Mbaa^laa^ki^yaa	ບາ^ລາ^ຄິ^ຢາ
Mbaa^laa^saa^tatv	ບາ^ລະ^ສະ^ທັດ
Mbaalukv	ບາ^ລຸກ
Mbaa^ti^me^atc	ບາ^ທິ^ເມ^ອັດ
Mbakc^mbu^ki^yaa	ບັກ^ບູ^ຄິ^ຢາ
Mbatc^litv	ບັດ^ລີດ
Mbatc^lutv	ບັດ^ລູດ
Mbe^en^se^mbun	ເບ^ເອນ^ເຊ^ບູນ
Mbe^le^ki^yaa	ເບ^ເລ^ຄິ^ຢາ
Mbe^ne Yaa^aa^kan	ເບ^ເນ^ຢາ^ອະ^ຄັນ
Mbe^ni^nu	ເບ^ນິ^ນູ
Mbetc Ye^si^motv	ເບດ^ເຢ^ຊິ^ໂມດ
Mbi^le^am	ບິ^ເລ^ອຳ
Mbi^ne^aa	ບິ^ເນ^ອາ
Mbi^si^o^ti^yaa	ບິ^ຊິ^ໂອ^ທິ^ຢາ
Mbi^ti^nie	ບິ^ທີ^ເນຍ
Mbi^ti^yaa	ບິ^ທິ^ຢາ
Mbikc^taa	ບິກ^ທາ
Mbikc^taa^naa	ບິກ^ທາ^ນາ
Mbikc^taan	ບິກ^ທານ
Mbikc^wai	ບິກ^ໄວ
Mbu^naa	ບຸ^ນາ
Mbusi	ບຸ^ຊີ
Mbukc^ki	ບຸກ^ຄີ
Mbukc^ki^yaa	ບຸກ^ຄີ^ຢາ
Ndaa^li^atc	ດາ^ລິ^ອັດ
Nde^li^laa	ເດ^ລິ^ລາ
Nde^metv^li^atc	ເດ^ເມັດ^ລິ^ອັດ
Ndi^le^an	ດິ^ເລ^ອັນ
Ndi^o^ni^si^atc	ດີ^ໂອ^ນິ^ສິ^ອັດ
Ndikc^laa	ດິກ^ລາ
Ndo^ndaa^waa^hu	ໂດ^ດາ^ວາ^ຫຸ
Ndo^faa^kaa	ໂດ^ຟະ^ຂາ
E^hutv	ເອ^ຮູດ
E^li^fe^le^hu	ເອ^ລີ^ຟາ^ເລ^ຫຸ
E^li^utc	ເອ^ລີ^ອູດ
E^li^yaa^sipv	ເອ^ລີ^ຢາ^ຊີ້ບ
Elun	ເອ^ລູນ
E^mekv Kesitv	ເອ^ເມັກ^ເຄ^ຊີດ
E^baa^fo^ndi^tatv	ເອ^ປາ^ໂຟ^ດິ^ທັດ
E^bi^ku^lien	ເອ^ປິ^ຄູ^ລຽນ
E^saa^laa	ເອ^ສະ^ລາ
E^saa^li	ເອ^ສະ^ລີ
E^wi	ເອ^ວີ
Em^maa^utc	ເອມ^ມາ^ອູດ
En^Mbelitv	ເອນ^ເບ^ລີດ
Faa^le^gon	ຟະ^ເລ^ໂກນ
Faa^li^si	ຟາ^ລິ^ສີ
Felikv	ເຟ^ລິກ
Fe^saa^tatv	ເຟ^ສະ^ທັດ
Fi^li^saa^die	ຟິ^ລິ^ສະ^ເຕຍ
Fi^nikv	ຟິ^ນິກ
Haa^e^lepv	ຫະ^ເອ^ເລບ
Haa^hi^lotv	ຫະ^ຫິ^ໂລດ
Haa^kaa^li^yaa	ຮາ^ຄາ^ລິ^ຢາ
Haa^lu^mapv	ຮາ^ລຸ^ມັບ
Haalum	ຮາ^ລູມ
Haalupv	ຮາ^ລູບ
Haa^mu^taan	ຮາ^ມຸ^ທານ
Haa^mun	ຮາ^ມູນ
Haanun	ຮາ^ນູນ
Haa^saa^bi^yaa	ຮາ^ຊາ^ປິ^ຢາ
Haa^saax^ndi^yaa	ຮາ^ສາ^ດິ^ຢາ
Haase Hatv^ti^kon	ຮາ^ເຊ^ຮັດ^ທິ^ໂຄນ
Haasum	ຮາ^ຊູມ
Haa^ti^faa	ຮາ^ທິ^ຟາ
Haa^ti^taa	ຮາ^ທິ^ທາ
Haa^wi^laa	ຮາ^ວິ^ລາ
Haa^yaa^ni^yaa	ຫະ^ຢາ^ນິ^ຢາ
Hakv^gitc	ຮັກ^ກີດ
Han^hun	ຮັນ^ຮູນ
Hatc^supv	ຫັດ^ຊູບ
He^li^o^mbu^li	ເຮ^ລີ^ໂອ^ບຸ^ລີ
He^lo^ndi^on	ເຮ^ໂລ^ດິ^ໂອນ
Hi^e^laa^mbu^li	ຮີ^ເອ^ລາ^ບຸ^ລີ
Ho^ndaa^wi^yaa	ໂຮ^ດາ^ວິ^ຢາ
Ho Hakv^gitc^gaatc	ໂຮ^ຮັກ^ກີດ^ກາດ
Hotv	ໂຮດ
Hufaam	ຫຸ^ຟາມ
Hugorkc	ຫຸ^ກອກ
Hu^laa^maa^mbi	ຫຸ^ລາ^ມາ^ບີ
Hulaam	ຫຸ^ລາມ
Hulai	ຫຸ^ໄລ
Huli	ຫ^ລີ
Husaa	ຫຸ^ຊາ
Husaam	ຫຸ^ຊາມ
Husai	ຫຸ^ໄຊ
Husim	ຫຸ^ຊິມ
Husopc	ຫຸ^ໂສບ
Hukc^gorkc	ຫຸກ^ກອກ
Hun	ຮູນ
I^ndaa^laa	ອິ^ດາ^ລາ
I^ndu^me^aa	ອິ^ດູ^ເມ^ອາ
Igaan	ອິ^ການ
I^ko^ni^yum	ອີ^ໂຄ^ນີ^ຢູມ
Ilaa	ອິ^ລະ
I^laa^aa	ອິ^ລາ^ອາ
Ilaa Naahaatc	ອິ^ລະ^ນາ^ຫາດ
Ilaam	ອິ^ລາມ
Ilaatv	ອິ^ລາດ
Ilai	ອິ^ໄລ
Ili	ອິ^ລີ
I^li^yaa	ອິ^ລີ^ຢາ
Ilu	ອິ^ລູ
In^li^kum	ອິນ^ລິ^ຄຸມ
I^opc	ອິ^ໂອບ
I^saa^kaa^li^otc	ອິ^ສະ^ຄາ^ລິ^ໂອດ
I^saa^laa	ອິ^ສະ^ລາ
I^saa^laa^en	ອິ^ສະ^ລາ^ເອນ
I^saa^laa^hi^yaa	ອິ^ສະ^ລາ^ຫິ^ຢາ
I^saa^li	ອິ^ສະ^ລີ
I^saa^li^yaa	ອິ^ສະ^ລິ^ຢາ
I^saa^maa^en	ອິ^ສະ^ມາ^ເອນ
I^saa^yaa	ອິ^ສະ^ຢາ
I^daa^li	ອິ^ຕາ^ລີ
I^taa^maa	ອິ^ທາ^ມາ
I^tai	ອິ^ໄທi-Ti-en > ອິ^ທີ^ເອນ
I^tu^lie	ອິ^ທູ^ເລຍ
I^ye^aa^laa^mbim	ອິ^ເຢ^ອາ^ລາ^ບິມ
I^yim	ອິ^ຢິມi-yon > ອິ^ໂຢນ
Ikc^ndaa^li^yaa	ອິກ^ດາ^ລິ^ຢາ
Ikc^ketc	ອິກ^ເຂດ
Itc^saa^maa^ki^yaa	ອິດ^ສະ^ມາ^ຄິ^ຢາ
Itc^wi	ອິດ^ວີ
Jor^laa^kev	ຈໍລະເຂັ
Kaa^laau^ndi^atc	ຄາ^ລາວ^ດີ^ອັດ
Gaa^li^li	ກາ^ລິ^ລີ
Kaa^litv^batc	ຄະ^ລິດ^ປັດ
Kaa^lo^e	ຄະ^ໂລ^ເອ
Gaa^maa^li^en	ກາ^ມາ^ລິ^ເອນ
Kaa^si^fie	ຄາ^ສິ^ເຟຍ
Gan^li^o	ກັນ^ລິ^ໂອ
Ge^ndaa^li^yaa	ເກ^ດາ^ລິ^ຢາ
Ge Haa^laa^sim	ເກ^ຫະ^ລາ^ຊິມ
Ge^haa^si	ເກ^ຫະ^ຊີ
Ke^len^hapc^bukc	ເຄ^ເລນ^ຫັບ^ປຸກ
Ke^li^otc	ເຄ^ລິ^ໂອດ
Ke^li^otc Hetv^lon	ເຄ^ລິ^ໂອດ^ເຮດ^ໂລນ
Ge^li^sim	ເກ^ລິ^ຊິມ
Ke^li^taa	ເຄ^ລິ^ທາ
Ke^litv	ເຄ^ລີ້ດ
Ke^litv^taa	ເຄ^ລີ້ດ^ທາ
Ke^lu^mbai	ເຄ^ລູ^ເປຍ
Ke^lu^hi	ເຄ^ລຸ^ຮ
Kelupv	ເຄ^ລູບ
Ge^lutv^kim^ham	ເກ^ລູດ^ຄິມ^ຮຳ
Ge^maa^li^yaa	ເກ^ມາ^ລິ^ຢາ
Ke^naa^aa^naa	ເຄ^ນາ^ອະ^ນາ
Ke^saa^lon	ເຄ^ສະ^ໂລນ
Ke^si^yaa	ເຄ^ສິ^ຢາ
Kesipv	ເຄ^ຊີບ
Gi^mbe^aa	ກິ^ເບ^ອາ
Gi^mbe^atc^e^lo^him	ກິ^ເບ^ອັດ^ເອ^ໂລ^ຮິມ
Gi^mbe^atc Haa^laa^lotv	ກິ^ເບ^ອັດ^ຮາ^ລາ^ໂລດ
Gi^mbe^on	ກິ^ເບ^ໂອນ
Gi^nde^o^ni	ກິ^ເດ^ໂອ^ນີ
Gi^nde^on	ກິ^ເດ^ໂອນ
Gi^ndom	ກິ^ໂດມ
Ki^ndon	ຄິ^ໂດນ
Gi^laa^lai	ກິ^ລາ^ໄລ
Ki^le^aapc	ຄິ^ເລ^ອາບ
Gi^le^aatc	ກິ^ເລ^ອາດ
Ki^li^ni^atc	ຄີ^ລິ^ນິ^ອັດ
Ki^li^on	ຄິ^ລິ^ໂອນ
Ki^li^yaa^taa^im	ຄິ^ລິ^ຢາ^ທາ^ອິມ
Ki^li^yaatv	ຄີ^ລິ^ຢາດ
Ki^li^yaatv Aalim	ຄີ^ລິ^ຢາດ^ອາ^ລິມ
Ki^li^yaatv Aan^mbaa	ຄີ^ລິ^ຢາດ^ອານ^ບາ
Ki^li^yaatv Mbaa^an	ຄີ^ລິ^ຢາດ^ບາ^ອັນ
Ki^li^yaatv^hu^sotv	ຄີ^ລິ^ຢາດ^ຫຸ^ໂຊດ
Ki^li^yaatv Sanx^naa	ຄີ^ລິ^ຢາດ^ສັນ^ນາ
Ki^li^yaatv Sefe	ຄີ^ລິ^ຢາດ^ເສ^ເຟ
Ki^li^yaatv Ye^aa^lim	ຄີ^ລິ^ຢາດ^ເຢ^ອາ^ລິມ
Gilon	ກິ^ໂລນ
Ki^si^on	ຄີ^ຊີ^ໂອນ
Kin Haa^le^setv	ຄີນ^ຫະ^ເລ^ເຊດ
Kitv	ຄີດ
Go^li^atc	ໂກ^ລິ^ອັດ
Ko^naa^ni^yaa	ໂຄ^ນາ^ນິ^ຢາ
Ko^ne^li^atc	ໂຄ^ເນ^ລິ^ອັດ
Ko^ni^yaa	ໂຄ^ນິ^ຢາ
Gokc	ໂກກ
Gopc	ໂກບ
Kotc	ໂຂດ
Gu^ni	ກຸ^ນີ
Kuqan Li^taa^im	ຄູ^ທຈັນ^ລິ^ທາ^ອິມ
Kumlaan	ຄູມ^ລານ
Kun	ຄູນ
Kutv	ຄູດ
Kutv^aa	ຄູດ^ອາ
Laa^aa^mi^yaa	ລາ^ອາ^ມິ^ຢາ
Laakitv	ລາ^ຄີ້ດ
Laamotv Gi^le^aatc	ລາ^ໂມດ^ກິ^ເລ^ອາດ
Lakv^kum	ລັກ^ຄູມ
Lapv^mbitc	ລັບ^ບີດ
Lapv^bi^ndotc	ລັບ^ປິ^ໂດດ
Lapv^saax^litv	ລັບ^ສາ^ລີດ
Le^haa^mbim	ເລ^ຫະ^ບິມ
Le^hum	ເລ^ຮູມ
Le^maa^li^yaa	ເລ^ມາ^ລິ^ຢາ
Le^wi^aa^taan	ເລ^ວີ^ອາ^ທານ
Le^yi^um	ເລ^ຢີ^ອູມ
Li^mbe^tin	ລີ^ເບ^ທີນ
Li^mbie	ລິ^ເບຍ
Li^ndie	ລິ^ເດຍ
Li^kaa^o^nie	ລີ^ຄາ^ໂອ^ເນຍ
Li^saa^daa	ລິ^ສະ^ຕາ
Likv^hi	ລິກ^ຮີ
Lo^lu^haa^maa	ໂລ^ລຸ^ຫະ^ມາ
Lotv	ໂລດ
Lu^hitv	ລູ^ຮີດ
Lu^si^atc	ລູ^ສິ^ອັດ
Lutv	ລູດ
Maa^aa^saix	ມະ^ອາ^ໄສ
Maa^aa^si^yaa	ມາ^ອາ^ຊິ^ຢາ
Maa^haa^laa^le^en	ມາ^ຫະ^ລາ^ເລ^ເອນ
Maa^haa^laa^len	ມາ^ຫະ^ລາ^ເລນ
Maa^haa^laapv	ມາ^ຫະ^ລາບ
Maa^haa^lai	ມາ^ຫະ^ໄລ
Maa^haa^latv	ມາ^ຫະ^ລັດ
Maa^haa^naa^im	ມາ^ຫະ^ນາ^ອິມ
Maa^haa^ne Ndaan	ມາ^ຫະ^ເນ^ດານ
Maa^haa^si^otc	ມາ^ຫະ^ຊິ^ໂອດ
Maa^haa^wai	ມາ^ຫະ^ໄວ
Maa^naa^sanx	ມະ^ນາ^ສັນ
Maa^natv^se	ມະ^ນັດ^ເສ
Makv^mbitc	ມັກ^ບີດ
Man^ki^yaa	ມັນ^ຄິ^ຢາ
Manlukv	ມັນ^ລຸກ
Matv^taa^ni^yaa	ມັດ^ທາ^ນີ^ຢາ
Matv^daa^taa	ມັດ^ຕະ^ທາ
Matv^ti^ti^yaa	ມັດ^ທີ^ທິ^ຢາ
Me^ndi^de^le^nien	ເມ^ດີ^ເຕ^ເລ^ນຽນ
Me^hi	ເມ^ຫ
�e^hi^ndaa	ິme-hi-Daa > ເມ^ຫິ^ດາ
Me^hu^maan	ເມ^ຫຸ^ມານ
Me^li^mbatc^kaa^ndetc	ເມ^ລິ^ບັດ^ດາ^ເດດ
Me^li^taa	ເມ^ລິ^ທາ
Me^se^le^mi^yaa	ເມ^ເຊ^ເລ^ມິ^ຢາ
Me^si^yaa	ເມ^ສິ^ຢາ
Migon	ມິ^ໂກນ
Milaa	ມິ^ລາ
Mi^laa^lai	ມິ^ລາ^ໄລ
Mi^le^tatv	ມິ^ເລ^ທັດ
Miliem	ມິ^ລຽມ
Misaa	ມິ^ຊາ
Mi^saa^en	ມິ^ຊາ^ເອນ
Misaan	ມິ^ຊານ
Misie	ມິ^ເຊຍ
Mi^ti^le^ni	ມິ^ທິ^ເລ^ນີ
Mi^yaa^min	ມິ^ຢາ^ມິນ
Mikv^ndan Gaatc	ມິກ^ຕັນ^ກາດ
Mikv^ndan En	ມິກ^ດັນ^ເອນ
Mikv^ndon	ມິກ^ໂດນ
Mikv^li	ມິກ^ລີ
Mikv^lotv	ມິກ^ໂລດ
Mikv^maatv	ມິກ^ມາດ
Mikv^me^tatv	ມິກ^ເມ^ທັດ
Mikv^ne^yaa	ມິກ^ເນ^ຢາ
Mitv^ndin	ມິດ^ດີນ
Mo^li^yaa	ໂມ^ລິ^ຢາ
mukv	ມຸກ
Naa^haa^laan	ນາ^ຫະ^ລານ
Naa^haa^lai	ນາ^ຫະ^ໄລ
Naa^haa^li^en	ນາ^ຫະ^ລີ^ເອນ
Naa^haa^lon	ນາ^ຫະ^ໂລນ
Naa^haa^maa^ni	ນາ^ຫະ^ມາ^ນີ
Naa^hum	ນາ^ຮູມ
Ne^aa^mbu^li	ເນ^ອາ^ບຸ^ລີ
Ne^mbu^saa^laa^ndaan	ເນ^ບູ^ຊາ^ລະ^ດານ
Ne^fi^simx	ເນ^ຟິ^ສິມ
Ne^haa^mi	ເນ^ຫະ^ມີ
Ne^hum	ເນ^ຮູມ
Ne^li^yaa	ເນ^ລິ^ຢາ
Ne^si^yaa	ເນ^ຊິ^ຢາ
Nesipv	ເນ^ຊີ້ບ
Ne^taa^ni^yaa	ເນ^ທາ^ນິ^ຢາ
Ni^kaa^no	ນິ^ຄາ^ໂນ
Ni^ko^mbu^li	ນິ^ໂຄ^ບຸ^ລີ
Ni^ko^lau^ni^yom	ນິ^ໂຄ^ເລົາ^ນິ^ໂຢມ
Ni^naa^we	ນິ^ນະ^ເວ
Nisaanx	ນິ^ສານ
Nitv^lotv	ນິດ^ໂລກ
Nopv	ໂນບ
Notv	ໂນດ
O^ne^si^fo^latv	ໂອ^ເນ^ສີ^ໂຟ^ລັດ
O^ne^si^matv	ໂອ^ເນ^ສີ^ມັດ
Okc	ໂອກ
Baa^laa^di^yaa	ປາ^ລາ^ຕິ^ຢາ
Batc^lu^simx	ປັດ^ລຸ^ສິມ
Be^kaa^hi^yaa	ເປ^ຄາ^ຫິ^ຢາ
Be^laa^li^yaa	ເປ^ລາ^ລິ^ຢາ
Be^lu^ndaa	ເປ^ລຸ^ດາ
Be^taa^hi^yaa	ເປ^ທາ^ຫິ^ຢາ
Be^tu^en	ເປ^ທຸ^ເອນ
Bi^haa^hi^lotv	ປິ^ຫະ^ຫິ^ໂລດ
Bi^laa^ton	ປິ^ລາ^ໂທນ
Bilatv	ປິ^ລັດ
Bi^si^ndie	ປິ^ສິ^ເດຍ
Bi^tom	ປິ^ໂທມ
Bi^ton	ປິ^ໂທນ
Bo^ti^faa	ໂປ^ທິ^ຟາ
Bo^ti^fe^laa	ໂປ^ທິ^ເຟ^ລາ
Bu^tai	ປຸ^ໄທ
Bu^ti^en	ປູ^ທິ^ເອນ
Bupc^li^atc	ປຸບ^ລິ^ອັດ
Putv	ພູດ
Bor^si^atc	ປໍ^ສິ^ອັດ
Born^ti^atc	ປອນ^ທິ^ອັດ
Saa^mbakc^taa^ni	ສະ^ປັກ^ທາ^ນີ
Saa^ndu^si	ສະ^ດູ^ສີs
Aa^haa^laa^im	ຊາ^ຫະ^ລາ^ອິມs
Aa^haa^su^maa	ຊາ^ຫະ^ຊຸ^ມາs
Aa^li^saa	ຊາ^ລິ^ຊາs
Aa^lo^me	ສະ^ໂລ^ເມ
Saa^lu^hen	ຊາ^ລຸ^ເຮນ
Saa^maa^lie	ສະ^ມາ^ເລຍ
Saa^me^naa	ສະ^ເມ^ນາ
Saaben	ສະ^ເປນ
Saa^taa^kitv	ສະ^ທາ^ຄິດ
Saa^te^faa^natv	ສະ^ເທ^ຟາ^ນັດ
Saa^te^fen	ສະ^ເທ^ເຟນ
Saa^do^ikc	ສະ^ໂຕ^ອິກ
Saa^waa^saa	ຊາ^ວະ^ຊາ
Sailin	ໄຊ^ລີນ
Sakc^kaa^li^yaa	ສະ^ຄາ^ລິ^ຢາ
Sam^mu^waa	ຊຳ^ມຸ^ວາ
Sanlum	ຊັນ^ລູມ
Se^aa^li^yaa	ເຊ^ອາ^ລິ^ຢາ
Se^aan^Yaasupv	ເຊ^ອານ^ຢາ^ຊູບ
Se^an^ti^en	ເຊ^ອັນ^ທິ^ເອນ
Se^mbaa^ni^yaa	ເຊ^ບາ^ນິ^ຢາ
Se^faa^ti^yaa	ເຊ^ຟາ^ທິ^ຢາ
Se^haa^li^yaa	ເຊ^ຫະ^ລິ^ຢາ
Se^kaa^ni^yaa	ເຊ^ຄາ^ນິ^ຢາ
Se^le^mi^yaa	ເຊ^ເລ^ມິ^ຢາ
Se^lu^mi^en	ເຊ^ລູ^ມິ^ເອນ
Se^maa^li^yaa	ເຊ^ມາ^ລິ^ຢາ
Se^mi^ndaa	ເຊ^ມິ^ດາ
Se^mi^laa^motv	ເຊ^ມິ^ລາ^ໂມດ
Se^mi^nitv	ເຊ^ມິ^ນິດ
Se^mbaa^ndi^yaa	ເສ^ບາ^ດິ^ຢາ
Se^mbi^ndaa	ເສ^ບີ^ດາ
Se^mbi^naa	ເສ^ບິ^ນາ
Se^kaa^kaa	ເສ^ຄະ^ຄາ
Se^kaa^li^yaa	ເສ^ຄາ^ລິ^ຢາ
Se^laa^hi^yaa	ເສ^ລາ^ຫິ^ຢາ
Se^lu^waa	ເສ^ລຸ^ວາ
Se^lu^yaa	ເສ^ລຸ^ຢາ
Selukv	ເສ^ລຸກ
Se^maa^ki^yaa	ເສ^ມາ^ຄິ^ຢາ
Se^mi^laa	ເສ^ມິ^ລາ
Siaa	ສິ^ອາ
Si^mbaa	ຊິ^ບາ
Si^mbe^on	ສິ^ເບ^ໂອນ
Si^mbi^yaa	ສິ^ບີ^ຢາ
Si^mbie	ສິ^ເບຍ
Si^e^ne	ສິ^ເອ^ເນ
Sifaa	ສິ^ຟາ
Sifi	ຊິ^ຟີ
Si^fi^yon	ສິ^ຟິ^ໂຢນ
Sifon	ສິ^ໂຟນ
Si^hox	ຊິ^ໂຫ
Sihox Lipv^naatv	ຊິ^ໂຫ^ລິບ^ນາດ
Si^honx	ສິ^ໂຫນ
Sikaa	ສິ^ຄາ
Si^gi^o^notv	ຊິ^ກິ^ໂອ^ໂນດ
Si^lie^fi^ni^sie	ຊີ^ເລຍ^ຟີ^ນິ^ເຊຍ
Si^me^aa	ຊິ^ເມ^ອາ
Si^me^am	ຊິ^ເມ^ອຳ
Si^me^atc	ຊິ^ເມ^ອັດ
Si^me^Iaa	ຊິ^ເມ^ລາ
Si^me^on	ສິ^ເມ^ໂອນ
Si^on	ສິ^ໂອນ
Si^saa^aa	ສິ^ຊາ^ອາ
Si^saa^mai	ສິ^ສະ^ໄມ
Sisakv	ຊິ^ຊັກ
Si^se^laa	ສິ^ເສ^ລາ
Si^si^li	ຊີ^ຊິ^ລີ
Sitie	ສິ^ເທຍ
Siwan	ສິ^ວັນ
Siyo	ສິ^ໂຢ
Sikc^laakv	ສິກ^ລາກ
Sikc^li	ສິກ^ລີ
Sikv^gaa^yon	ຊິກ^ກາ^ໂຢນ
Sikv^ke^lon	ຊິກ^ເຄ^ໂລນ
Sin^hi	ຊິນ^ຫິ
Sinx^ti^ke	ສິນ^ທິ^ເຄ
So^saa^te^netv	ໂສ^ສະ^ເທ^ເນດ
So^si^baa^te	ໂສ^ສິ^ປາ^ເທ
Su^aa	ສຸ^ອາ
Sufaa	ສຸ^ຟາ
Sukaa	ສຸ^ຄາ
Su^ki^im	ສຸ^ຄີ^ອິມ
Susaax	ສຸ^ສາ
Su^sanx^naa	ສຸ^ສັນ^ນາ
Susi	ສຸ^ສີ
Sux^li^en	ສູ^ລິ^ເອນ
Sux^li^satv^ndai	ສູ^ລິ^ຊັດ^ໄດ
Sukc^kotv	ສຸກ^ໂຄດ
Sukc^kotv^mbe^notv	ສຸກ^ໂຄດ^ເບ^ໂນດ
Supc	ສູບ
Taa^aa^natv Silo	ທາ^ອາ^ນັດ^ຊິ^ໂລ
Taa^mbi^taa	ທາ^ບິ^ທາ
Daa^ko^ni^ditc	ຕາ^ໂຄ^ນິ^ຕິດ
Taa^laa^laa	ທາ^ລະ^ລາ
Taa^li^taa^ku^mi	ທາ^ລິ^ທາ^ຄູ^ມິ
Tailaqv	ໄທ^ລະ
Tan^hu^metv	ທັນ^ຫຸ^ເມດ
Te^mbaa^li^yaa	ເທ^ບາ^ລິ^ຢາ
Te^saa^lo^ni^gaa	ເທ^ສະ^ໂລ^ນິ^ກາ
Te^ti^atc	ເທ^ທິ^ອັດ
Ti^mbe^li^atc	ທິ^ເບ^ລິ^ອັດ
Ti^mbe^lietv	ທິ^ເບ^ລຽດ
Ti^ndaan	ທິ^ດານ
Ti^ki^gatc	ທີ^ຄິ^ກັດ
Ti^laa^haa^kaa	ທີ^ລະ^ຫະ^ຄາ
Ti^laa^haa^naa	ທີ^ລະ^ຫະ^ນາ
Ti^laa^saa	ທີ^ລະ^ຊາ
Ti^laa^tai	ທິ^ລາ^ໄທ
Tilaatv	ທິ^ລາດ
Ti^li^yaa	ທິ^ລີ^ຢາ
Tilon	ທິ^ໂລນ
Ti^me^atc	ທິ^ເມ^ອັດ
Ti^mo^tai	ທິ^ໂມ^ໄທ
Timon	ທິ^ໂມນ
Tisai	ທິ^ໄຊ
Tidatc	ທິ^ຕັດ
Ti^datc^yu^saa^tatv	ທິ^ຕັດ^ຢຸ^ສະ^ທັດ
Ti^yaa^ti^laa	ທິ^ຢາ^ທິ^ລາ
Tikc^waa	ທິກ^ວາ
Tikv^latv^Bi^le^se	ທິກ^ລັດ^ປິ^ເລ^ເສ
Tohu	ໂທ^ຫຸ
Topv^Aa^ndo^ni^yaa	ໂທບ^ອາ^ໂດ^ນິ^ຢາ
Totv^mbu^li	ໂທັດ^ບຸ^ລີ
Tu^ndaatc	ທຸ^ດາດ
Ufaatv	ອຸ^ຟັາດ
Ulaam	ອຸ^ລາມ
Uli	ອຸ^ລີ
U^li^aa	ອຸ^ລີ^ອາ
U^li^en	ອຸ^ລີ^ເອນ
U^li^yaa	ອຸ^ລີ^ຢາ
Ulim	ອຸ^ລີມ
Usaan	ອຸ^ຊານ
Usai	ອຸ^ໄຊ
Utai	ອຸ^ໄທ
Utc	ອູດ
Waa^ni^yaa	ວາ^ນິ^ຢາ
Yaa^aa^su	ຢາ^ອາ^ສຸ
Yaa^mbetc Gi^le^aatc	ຢາ^ເບດ^ກິ^ເລ^ອາດ
Yaakin	ຢາ^ຄີນ
Yaagun	ຢາ^ກູນ
Yaa^laa^haa	ຢາ^ລະ^ຮາ
Yaalipv	ຢາ^ລີບ
Yaa^min	ຢາ^ມີນ
Yaasitv	ຢາ^ຊີດ
Yaasupv	ຢາ^ຊູບ
Yaanmutv	ຢານ^ມູດ
Ye^ndi^ndi^yaa	ເຢ^ດີ^ດິ^ຢາ
Ye^ndu^tun	ເຢ^ດູ^ທູນ
Ye^ho^waa^yi^le	ເຢ^ໂຮ^ວາ^ຢິ^ເລ
Ye^ho^yaa^kin	ເຢ^ໂຮ^ຢາ^ຄີນ
Ye^hutv	ເຢ^ຮູດ
Ye^kaa^mi^yaa	ເຢ^ຄາ^ມິ^ຢາ
Ye^si^mi^en	ເຢ^ສິ^ມີ^ເອນ
Ye^si^mon	ເຢ^ຊິ^ໂມນ
Ye^si^sai	ເຢ^ຊິ^ໄຊ
Ye^utc	ເຢ^ອູດ
Yen^ne^saa^letv	ເຢນ^ເນ^ຊາ^ເລດ
Yilon	ຢິ^ໂລນ
Yitv^le^en	ຢິດ^ເລ^ເອນ
Yitv^saa^laa^yaa	ຢິດ^ສະ^ລາ^ຢາ
Yo^laa^ke^am	ໂຢ^ລະ^ເຄ^ອຳ
Yo^saa^wi^yaa	ໂຢ^ຊາ^ວິ^ຢາ
Yo^si^mbi^yaa	ໂຢ^ຊິ^ບີ^ຢາ
Yo^si^fi^yaa	ໂຢ^ສິ^ຟີ^ຢາ
Yo^si^yaa	ໂຢ^ສິ^ຢາ
Yopv	ໂຢບ
Yu^saa^tatv	ຢຸ^ສະ^ທັດ
Yu^ti^gatc	ຢຸ^ທິ^ກັດ
#new-stuff	#new-stuff
Gin^mbo^aa	ກິນ^ໂບ^ອາ
Jetc^si	ຈຽດ^ຊີ
gu'nyuoz	ກະຍົ໌ວ
mbu'ndongx	ບຸດົ໋ງ
Aa^ndun^lam	ອາ^ດຸນ^ລຳ
la'bieiv-zorng	ຫລະເປຢີ໊ຍ-ຕສອງ
Naatan	ນາ^ທັນ
Selekv	ເສ^ເລກ
Utc^si^yaa	ອຸດ^ຊີ^ຢາ
Me^tu^se^laa	ເມ^ທູ^ເສ^ລາ
Kitv^tim	ຄິດ^ທິມ
Si^ni	ສີ^ນີ
Temaa	ເທ^ມາ
Yetu	ເຢ^ທູ
Temaan	ເທ^ມານ
Sefi	ເສ^ຟີ
Se^i	ເສ^ອີ
Lotaan	ໂລ^ທານ
Mbin^haan	ບິນ^ຮານ
Ndin^haa^mbaa	ດິນ^ຮາ^ບາ
Mbaa^an Haanan	ບາ^ອັນ^ຮາ^ນັນ
Me^Saahapc	ເມ^ຊາ^ຫັບ
Yetetv	ເຢ^ເທດ
zanc-zanc	ຕສັ່ນໆ
mengh mengh	ເມ່ງໆ
Maako	ມາ^ໂຄ
za'gengh	ຕສະເກ້ງ
mv	ມ້
Simon	ຊີ^ມົນ
la'kuqv	ຫລະຄຸ
Yoaatc	ໂຢ^ອາດ
da'hmz	ຕະຮມ໌ມ
hietc	ຫຮຢຽດ
Se^mbu^lun	ເສ^ບູ^ລຸນ
Haamatv	ຮາ^ມັດ
zueiz	ເຕສວີ໌ຍ
Utc^saa	ອຸດ^ຊາ
Beletv Utc^saa	ເປ^ເລດ^ອຸດ^ຊາ
si^ndaa	ສີ^ດາ
Mbaa^an Be^laa^sim	ບາ^ອັນ^ເປ^ລາ^ຊິມ
Utc^si^en	ອຸດ^ຊີ^ເອນ
Maa^aa^se^aa	ມາ^ອາ^ເສ^ອາ
Mikaan	ມີ^ຄານ
Yaakopv	ຢາ^ຄົບ
Ko^lin^to	ໂຄ^ລິນ^ໂທ
So^mbaa	ໂສ^ບາ
uix	ຫວຸຍ
#Aalam Naa^haa^laa^im	#ອາ^ລຳ^ນາ^ຫະ^ລາ^ອິມ
#unchecked	#unchecked
mv baac	ມປ່າ
Ndaawitv	ດາ^ວິດ
zaangc	ຕສັ່ງ
Saulo	ເຊົາ^ໂລ
Ndaagon	ດາ^ກົນ
Mben^yaa^min	ເບນ^ຢາ^ມິນ
Beletv	ເປ^ເລດ
Haalipv	ຮາ^ລິບ
Kolaa	ໂຄ^ລາ
mbaali	ບາ^ລີ
Haalotv	ຮາ^ລົດ
Sammotv	ຊຳ^ມົດ
Belon	ເປ^ລົນ
Heletv	ເຮ^ເລດ
Gimso	ກິມ^ໂຊ
Haasem	ຮາ^ເຊມ
Haalaan	ຮາ^ລານ
Saagi	ຊາ^ກີ
Haalaa	ຮາ^ລາ
Hefe	ເຮ^ເຟ
Kaanmen	ຄານ^ເມນ
Haagi	ຮາ^ກີ
Ammon	ອຳ^ມົນ
Mbe^e^lotv	ເບ^ເອ^ລົດ
Gaalepv	ກາ^ເລບ
Atc^taa^lotv	ອັດ^ທາ^ລົດ
Sammaa	ຊຳ^ມາ
Simli	ຊິມ^ລີ
Yaa^aa^si^en	ຢາ^ອາ^ຊີ^ເອນ
Ese	ເອ^ເຊ
Aalon	ອາ^ລົນ
Aase	ອາ^ເຊ
Nogaa	ໂນ^ກາ
Nefekv	ເນ^ເຟກ
Yaafie	ຢາ^ເຟຍ
Gese	ເກ^ເຊ
huing	ຮວີງ
Geson	ເກ^ຊົນ
Mose	ໂມ^ເຊ
Aasaapc	ອາ^ສາບ
Unni	ອຸນ^ນີ
Efotv	ເອ^ຟົດ
Isakc	ອີ^ສັກ
Hosaax	ໂຮ^ສາ
Silie	ຊີ^ເລຍ
Aalam	ອາ^ລຳ
gilo	ກີ^ໂລ
Sofakv	ໂຊ^ຟັກ
E^notv	ເອ^ນົດ
Yaaletv	ຢາ^ເລດ
Noyaa	ໂນ^ຢາ
Yaafetv	ຢາ^ເຟດ
Maagokc	ມາ^ກົກ
Yaawaan	ຢາ^ວານ
Tu^mban	ທູ^ບັນ
Mesekv	ເມ^ເຊກ
Lifaatv	ລີ^ຟາດ
Taansitv	ທານ^ຊິດ
Nimlotv	ນິມ^ລົດ
Aankaa	ອານ^ຄາ
Aanwatv	ອານ^ວັດ
Elaam	ເອ^ລາມ
se^me^nitv	ເຊ^ເມ^ນິດ
Belekv	ເປ^ເລກ
Selepv	ເຊ^ເລບ
Yelaa	ເຢ^ລາ
Ofi	ໂອ^ຟີ
Telaa	ເທ^ລາ
Naafitv	ນາ^ຟິດ
Suwaa	ຊູ^ວາ
Efaa	ເອ^ຟາ
Efe	ເອ^ເຟ
Esaau	ເອ^ຊາວ
Yaalaam	ຢາ^ລາມ
Timnaa	ທິມ^ນາ
Elaa	ເອ^ລາ
Minkom	ມິນ^ຄົມ
Molekv	ໂມ^ເລກ
huotv	ເຮວີດ
Saadaan	ຊາ^ຕານ
Onan	ໂອ^ນັນ
huin	ຮວິນ
Setaam	ເສ^ທາມ
Si^naa	ຊີ^ນາ
Amlaam	ອຳ^ລາມ
Gesom	ເກ^ຊົມ
Mikaa	ມີ^ຄາ
#Maali	#ມາ^ລີ
Musi	ມູ^ຊີ
Haalim	ຮາ^ລິມ
Se^o^lim	ເສ^ໂອ^ລິມ
Hakv^kotc	ຮັກ^ຂົດ
Ye^su^aa	ເຢ^ຊູ^ອາ
Yosepv	ໂຢ^ເຊບ
Seli	ເສ^ລີ
Kole	ໂຄ^ເລ
Yoaa	ໂຢ^ອາ
Yolam	ໂຢ^ລຳ
Yaase	ຢາ^ເຊ
Mikc^lotv	ໝິກ^ລົດ
Omli	ອົມ^ລີ
huingx	ຫຮວີງ
Sefaam	ເຊ^ຟາມ
Saalon	ຊາ^ລົນ
Saafatv	ຊາ^ຟັດ
Ndison	ດີ^ຊົນ
Ndisaan	ດີ^ຊານ
Holi	ໂຮ^ລີ
Sefo	ເສ^ໂຟ
Aiyaa	ໄອ^ຢາ
Hamlaan	ຮຳ^ລານ
Kelaan	ເຄ^ລານ
Aalan	ອາ^ລັນ
Mbelaa	ເບ^ລາ
Me^lo^nopv	ເມ^ໂລ^ນົບ
Haagaa	ຮາ^ກາ
Aanki	ອານ^ຄີ
Taamaa	ທາ^ມາ
Kaanko	ຄານ^ໂຄ
Ndaalaa	ດາ^ລາ
Kaanmi	ຄານ^ມີ
Kaalepv	ຄາ^ເລບ
Naason	ນາ^ຊົນ
Osem	ໂອ^ເຊມ
Yete	ເຢ^ເທ
Yese	ເຢ^ເຊ
Maaki	ມາ^ຄີ
Segupc	ເສ^ກຸບ
Haau^wotv Yaa^i	ຮາວ^ວົດ^ຢາ^ອີ
Olen	ໂອ^ເລນ
Sammai	ຊຳ^ໄມ
Molitv	ໂມ^ລິດ
Seletv	ເສ^ເລດ
Sesan	ເຊ^ຊັນ
Efaan	ເອ^ຟານ
Mesaa	ເມ^ຊາ
Lekem	ເລ^ເຄມ
Mbetc Su	ເບດ^ຊູ
Mosaa	ໂມ^ຊາ
Yotaam	ໂຢ^ທາມ
Gesaan	ເກ^ຊານ
Sewaa	ເຊ^ວາ
Haaletv	ຮາ^ເລດ
Solaa	ໂສ^ລາ
Atc^lotv^mbetc^yo^aapc	ອັດ^ລົດ^ເບດ^ໂຢ^ອາບ
Lekaapv	ເລ^ຄາບ
Amnon	ອຳ^ນົນ
Gesu	ເກ^ຊູ
Tanmai	ທັນ^ໄມ
Mbatc^se^mbaa	ບັດ^ເຊ^ບາ
Aasaax	ອາ^ສາ
Se^nde^ki^yaa	ເສ^ເດ^ຄີ^ຢາ
Se^lupv^mbaa^mben	ເສ^ລຸບ^ບາ^ເບນ
Yusapv^Hesetc	ຢູ^ຊັບ^ເຮ^ເສດ
Aannan	ອານ^ນັນ
Edaam	ເອ^ຕາມ
Helaa	ເຮ^ລາ
Se^letc	ເສ^ເຫລດ
So^mbe^mbaa	ໂສ^ເບ^ບາ
Mbetc Laafaa	ເບດ^ລາ^ຟາ
Baa^se^aa	ປາ^ເສ^ອາ
Lekaa	ເລ^ຄາ
Se^lai^aa	ເສ^ໄລ^ອາ
Meletv	ເມ^ເລດ
Yaalon	ຢາ^ລົນ
Faalo	ຟາ^ໂລ
Yeletv	ເຢ^ເລດ
Soko	ໂສ^ໂຄ
Gelem	ເກ^ເລມ
Linnaa	ລິນ^ນາ
So^hetc	ໂສ^ເຫດ
Mben^Sohetv	ເບນ^ໂຊ^ເຮດ
Ko^se^mbaa	ໂຄ^ເຊ^ບາ
Yokim	ໂຢ^ຄິມ
Esem	ເອ^ເຊມ
Tolatv	ໂທ^ລັດ
Homaa	ໂຮ^ມາ
Mbetc Maan^kaa^mbotc	ເບດ^ມານ^ຄາ^ບົດ
Haasaan Sux^simx	ຮາ^ຊານ^ສູ^ສິມ
Aayin	ອາ^ຢິນ
Limmon	ລິມ^ມົນ
Token	ໂທ^ເຄນ
Aaqan	ອາ^ທຈັນ
Yamlekv	ຢຳ^ເລກ
Sisaa	ຊີ^ຊາ
Se^mai^aa	ເຊ^ໄມ^ອາ
Banlu	ປັນ^ລູ
Aasaatv	ອາ^ຊາດ
Se^maa	ເຊ^ມາ
Mbaa^an Me^on	ບາ^ອັນ^ເມ^ອົນ
Mbaasaan	ບາ^ຊານ
Saafaam	ຊາ^ຟາມ
Yolai	ໂຢ^ໄລ
Mbaa^an Hemon	ບາ^ອັນ^ເຮ^ມົນ
Seni	ເສ^ນີ
Hemon	ເຮ^ມົນ
hieh	ເຮຢ່ຍ
Bunle	ປຸນ^ເລ
Gosaan	ໂກ^ຊານ
Utc^si	ອຸດ^ຊີ
Atc^si	ອັດ^ສີ
Sofai	ໂສ^ໄຟ
Se^fan^yaa	ເສ^ຟັນ^ຢາ
Mbaa^aa^se^yaa	ບາ^ອາ^ເສ^ຢາ
Kisi	ຄີ^ຊີ
Amsi	ອຳ^ຊີ
Hilen	ຮີ^ເລນ
Mbetc Semetv	ເບດ^ເຊ^ເມດ
Sekem	ເຊ^ເຄມ
Mbetc^Holon	ເບດ^ໂຮ^ລົນ
Gatc Limmon	ກັດ^ລິມ^ມົນ
Golaan	ໂກ^ລານ
Laamotv	ລາ^ມົດ
Maasaan	ມາ^ຊານ
Hammon	ຮຳ^ມົນ
Kaantaa	ຄານ^ທາ
Yaasaa	ຢາ^ຊາ
Tolaa	ໂທ^ລາ
Simlon	ຊິມ^ລົນ
Mbeke	ເບ^ເຄ
Setaan	ເສ^ທານ
Sinlem	ຊິນ^ເລມ
Se^lo^fe^hatc	ເສ^ໂລ^ເຟ^ຫັດ
Laakem	ລາ^ເຄມ
Itv^hotv	ອິ໊ດ^ຮົດ
Melaa	ເມ^ລາ
Mbeletv	ເບ^ເລດ
Lefaa	ເລ^ຟາ
Lesepv	ເລ^ເຊບ
Mbetc Saan	ເບດ^ຊານ
Imnaa	ອິມ^ນາ
Baasakc	ປາ^ສັກ
Logaa	ໂລ^ກາ
Sofaa	ໂສ^ຟາ
Mbeli	ເບ^ລີ
Imlaa	ອິມ^ລາ
Sinsaa	ຊິນ^ຊາ
Aalaa	ອາ^ລາ
Unlaa	ອຸນ^ລາ
Lisiex	ລີ^ເສຍ
Laafaa	ລາ^ຟາ
Gelaa	ເກ^ລາ
Minmaa	ມິນ^ມາ
Se^metv	ເຊ^ເມດ
Ono	ໂອ^ໂນ
Saasakv	ຊາ^ຊັກ
Aalaatv	ອາ^ລາດ
Yaakim	ຢາ^ຄິມ
Simlaatv	ຊິມ^ລາດ
Seke	ເສ^ເຄ
Melipv^Mbaa^an	ເມ^ລິບ^ບາ^ອັນ
Melekv	ເມ^ເລກ
Taalie	ທາ^ເລຍ
Aasen	ອາ^ເຊນ
Esekv	ເອ^ເຊກ
Imli	ອິມ^ລີ
Silo	ຊີ^ໂລ
Hatc^se^nu^aa	ຫັດ^ເສ^ນູ^ອາ
Imme	ອິມ^ເມ
He^letv^se	ເຮ^ເລດ^ເສ
Gaalaan	ກາ^ລານ
Tanmon	ທັນ^ມົນ
Yaalaa	ຢາ^ລາ
nyei	ເຍີຍ
Timnaatv Selaa	ທິມ^ນາດ^ເສ^ລາ
Jatv	ຈ໊ຽດ
kouv	ໂຄ້ວ
Mene	ເມ^ເນ
Mole	ໂມ^ເລ
Neko	ເນ^ໂຄ
Yesu	ເຢ^ຊູ
Minlo	ມິນ^ໂລ
wuov-ndaangc	ອັ້ວ-ດ່າງ
Giduc	ກີ^ຕູ່
Silaa	ຊີ^ລາ
Se^laa^saa	ເສ^ລາ^ຊາ
Laasen	ລາ^ເຊນ
guinh	ກວິ້ນ
Maadi	ມາ^ຕີ
Mbesekv	ເບ^ເຊກ
Yelupv^Mbaa^an	ເຢ^ລຸບ^ບາ^ອັນ
Yepv^taa	ຢ໊ຽບ^ທາ
nzaangc	ດສັ່ງ
Mbetc Aawen	ເບດ^ອາ^ເວນ
Mbosetv	ໂບ^ເຊດ
Sene	ເສ^ເນ
Melaapv	ເມ^ລາບ
Kenai	ເຄ^ໄນ
Aagakc	ອາ^ກັກ
Sekenx	ເຊ^ເຂນ
guenx	ເກວ໋ນ
Ekon	ເອ^ຄົນ
Naayotv	ນາ^ຢົ໊ດ
Seku	ເສ^ຄູ
Baalaan	ປາ^ລານ
Ganlim	ກັນ^ລິມ
Banti	ປັນ^ທີ
Maa^okc	ມາ^ອົກ
Negepc	ເນ^ເກບ
#u^lim	#ອຸ^ລີມ
kuinx	ຂວິນ
Mbeso	ເບ^ໂສ
Laakaan	ລາ^ຄານ
Aataakv	ອາ^ທາກ
Eli	ເອ^ລີ
Selo	ເສ^ໂລ
Baulo	ເປົາ^ໂລ
Haawaa	ຮາ^ວາ
Bilaatv	ປີ^ລາດ
Bide	ປີ^ເຕ
Helotv	ເຮ^ລົດ
Taasatv	ທາ^ຊັດ
Saibatc	ໄຊ^ປັດ
An^ti^okc	ອັນ^ທີ^ອົກ
Yannetv	ຢັນ^ເນດ
Mbe^e^se^mbaa	ເບ^ເອ^ເຊ^ບາ
Hesi	ເຮ^ຊີ
# auto added	#auto added
Aa^kuin^laa	ອາ^ຄວິນ^ລາ
Aa^li^okc	ອາ^ລີ^ອົກ
Aafekv	ອາ^ເຟກ
Aahapc	ອາ^ຫັບ
Aakitv	ອາ^ຄິດ
Aalapc	ອາ^ຫລັບ
Aannon	ອານ^ນົນ
Annaatv	ອັນ^ນາດ
Atc^si^lie	ອັດ^ຊີ^ເລຍ
Bekaa	ເປ^ຄາ
Besie	ເປ^ເຊຍ
E^se^ken	ເອ^ເສ^ເຄນ
Elon	ເອ^ລົນ
En Ge^ndi	ເອນ^ເກ^ດີ
Esie	ເອ^ເຊຍ
Filipv	ຟີ^ລິບ
Gaasaa	ກາ^ຊາ
Gosen	ໂກ^ເຊນ
Haa^mbaa^gukc	ຮາ^ບາ^ກຸກ
Haaso	ຮາ^ໂຊ
Hannaa	ຮັນ^ນາ
Holepv	ໂຮ^ເລບ
Hun^ndaa	ຮຸນ^ດາ
Kison	ຄີ^ຊົນ
Kitv^lon	ຄິດ^ລົນ
Ko^lo^si	ໂຄ^ໂລ^ສີ
Le^mbo Haamatv	ເລ^ໂບ^ຮາ^ມັດ
Lesin	ເລ^ຊິນ
Lomaa	ໂລ^ມາ
Lugaa	ລູ^ກາ
Lute	ລູ^ເທ
Maalaa	ມາ^ລາ
Maali	ມາ^ລີ
Maataa	ມາ^ທາ
Mamle	ມຳ^ເລ
Mbaalaakv	ບາ^ລາກ
Mben^Hinnom	ເບນ^ຮິນ^ນົມ
Mbinnui	ບິນ^ນຸຍ
Me^so^bo^de^mie	ເມ^ໂສ^ໂປ^ເຕ^ເມຍ
Memfitv	ເມມ^ຟິດ
Mesaakv	ເມ^ຊາກ
Minkaa	ມິນ^ຄາ
Naasi	ນາ^ສີ
Saafaan	ຊາ^ຟານ
Saalaa	ຊາ^ລາ
Saalaai	ຊາ^ລາຍ
Saalem	ຊາ^ເລມ
Sailatv	ໄຊ^ລັດ
Se^faan^waa^im	ເສ^ຟານ^ວາ^ອິມ
Se^mbaa	ເຊ^ບາ
Se^mbe^ndi	ເສ^ເບ^ດີ
Se^mbun	ເສ^ບຸນ
So^aa	ໂສ^ອາ
So^an	ໂສ^ອັນ
So^ndom	ໂສ^ດົມ
Sunem	ຊູ^ເນມ
Tofetv	ໂທ^ເຟດ
Tummim	ທຸມ^ມິມ
Yaagorpc	ຢາ^ກອບ
Ye^ko^ni^yaa	ເຢ^ໂຄ^ນີ^ຢາ
Yeto	ເຢ^ໂທ
Yiutai	ຢິວ^ໄທ
Yonaa	ໂຢ^ນາ
aqc mangc	ອະໝັ່ງ
ga'hlen	ກະເຮລນ
ga'nyiec	ກະເຫຍ່ຍ
guen	ເກວນ
guetv	ເກວ໊ດ
hienx	ຫຮຢຽນ
hietv	ຮຢຽດ
hiun	ຮຢຸນ
hui	ຮວີ
hui-baeqc	ຮວີ-ແປະ
huon	ເຮວີນ
jiem-kuing	ຈຽມ-ຄວີງ
ka'ndau	ຂະເດົາ
kuing	ຄວີງ
la'ngopv	ຫລະອົ໊ບ
loh	ໂລ່
mbiungc	ບຢູ່ງ
mbiungc-nziaaux	ບຢູ່ງ-ດສຢ໋າວ
mbiungc-suiv	ບຢູ່ງ-ຊຸ້ຍ
mbu'ziex	ບຸເຕສ໋ຍ
niaa	ນີຢາ
nquin	ອກວິນ
yieqv	ເຢັ໊ຍ
Aa^se^natv	ອາ^ເສ^ນັດ
Aa^taa^lotv	ອາ^ທາ^ລົດ
Aagu	ອາ^ກູ
Aan^gopc	ອານ^ກົບ
Aanni	ອານ^ນີ
Aasor	ອາ^ຊໍ
Annaa	ອັນ^ນາ
Baa^hatc Mo^apc	ປາ^ຫັດ^ໂມ^ອັບ
Baafotv	ປາ^ຟົດ
Baalaa	ປາ^ລາ
Baalotv	ປາ^ລົດ
Batc^lotv	ປັດ^ລົດ
Begaa	ເປ^ກາ
Bulaa	ປູ^ລາ
Bulim	ປູ^ລິມ
da'faanh	ຕະຟ່ານ
E^li^se^mbaa	ເອ^ລີ^ເຊ^ບາ
E^si^on Ge^mbe	ເອ^ຊີ^ອົນ^ເກ^ເບ
Elatv	ເອ^ລັດ
Elim	ເອ^ລິມ
En Gannim	ເອນ^ກັນ^ນິມ
En Semetv	ເອນ^ເຊ^ເມດ
Faalo Neko	ຟາ^ໂລ^ເນ^ໂຄ
Fiko	ຟີ^ໂຄ
Gatc Hefe	ກັດ^ເຮ^ເຟ
Ge^li^lotv	ເກ^ລີ^ລົດ
Ge^nde^lotv	ເກ^ເດ^ລົດ
Gesem	ເກ^ເຊມ
Getc^se^maa^ni	ເກດ^ເສ^ມາ^ນີ
Haa^le^lu Yaa	ຮາ^ເລ^ລູ^ຢາ
Haa^se^lotv	ຮາ^ເຊ^ລົດ
Haalakv	ຮາ^ລັກ
Haasaa Lenon	ຮາ^ຊາ^ເລ^ນົນ
Haulaan	ເຮົາ^ລານ
He^se^ki^yaa	ເຮ^ເຊ^ຄີ^ຢາ
#new additions
Tin Deic	ທິນ ເຕີ່ຍ
Ceng Tin-hungh	ເທສງ ທິນ-ຮູ່ງ
zungh zungh	ຕສູ້ງໆ
Bison	ປີ^ຊົນ
Taigitc	ໄທ^ກິດ
guinh guinh	ກວິ້ນໆ
Tu^mban Kaa^in	ທູ^ບັນ^ຄາ^ອິນ
Nefin	ເນ^ຟິນ
Se^me Mienh	ເສ^ເມ ມ່ຽນ
Se^mbo^yim	ເສ^ໂບ^ຢິມ
Sefaa	ເສ^ຟາ
# sometimes this is used, sometimes not!
dauh dauh	ເຕົ້າໆ
Se^mbo^yim Zingh	ເສ^ໂບ^ຢິມ ຕສີ້ງ
Aa^le^okc	ອາ^ເລ^ອົກ
samh samh	ຊ່ຳໆ
So^haax	ໂສ^ຫາ
nie-ha'louh	ເນຍ-ຫະໂລ່ວ
So^haa	ໂສ^ຮາ
Batc^ndaan Aalam	ປັດ^ດານ^ອາ^ລຳ
Mbaa^se^matv	ບາ^ເສ^ມັດ
guanh guanh	ກວັ້ນໆ
baeqc baeqc	ແປະໆ
En E^lo^he I^saa^laa^en	ເອນ^ເອ^ໂລ^ເຮ^ອີ^ຊາ^ລາ^ເອນ
En Mbetc^en	ເອນ^ເບດ^ເອນ
mbeix mbeix	ເບີ໋ຍໆ
nzauh nzauh	ເດສົ້າໆ
Saax^fe^naatv Baa^ne^aa	ສາ^ເຟ^ນາດ^ປາ^ເນ^ອາ
Sefon	ເສ^ຟົນ
zioucj	ຕສ່ຽວ
ngamh ngamh	ງ່ຳໆ
ngomh ngomh	ງົ່ມໆ
njapc njapc	ອຈັບໆ
njunh njunh	ອຈຸ້ນໆ
mbiouh mbiouh	ບ້ຽວໆ
Mbaa^an Sefon	ບາ^ອັນ^ເຊ^ຟົນ
zuei zuei	ເຕສວີຍໆ
kou kou	ໂຄວໆ
lorqc lorqc	ເຫລາະໆ
guengx	ເກວ໋ງ
congx congx	ຖສົງໆ
Ye^ho^waa Nitv^si	ເຢ^ໂຮ^ວາ ນິດ^ສີ
jaax-zi'n'h	ຈ໋າ-ຕສິນຮ
Supc^aa	ສຸບ^ອາ
Kaa^ndetc Mbaa^nie	ຄາ^ເດດ^ບາ^ເນຍ
Yiem Kaa^ndetc Mbaa^nie	ຢຽມ ຄາ^ເດດ^ບາ^ເນຍ
Si^li^orn	ສີ^ລີ^ອອນ
Aa^mo^lai	ອາ^ໂມ^ໄລ
diuh diuh	ຕິ້ວໆ
Kipc^lotv Hatc^daa^aa^waa	ຂິບ^ລົດ^ຫັດ^ຕາ^ອາ^ວາ
Mbe^e^lotv Mbe^ne^yaa^aa^kan	ເບ^ເອ^ລົດ^ເບ^ເນ^ຢາ^ອາ^ຄັນ
Mo^se^laa	ໂມ^ເສ^ລາ
Mbetc Be^o	ເບດ^ເປ^ໂອ
ndiangx-gaa'mat	ດຢັ໋ງ-ກ໌າມັດ
zaengh zaengh	ແຕສ້ງໆ
yie'm'zangc	ຢຽມຕສັ່ງ
So^ndi	ໂສ^ດີ
Setu	ເສ^ທູ
Wopv^si	ວົບ^ສີ
I^ye Aa^mbaa^lim	ອີ^ເຢ^ອາ^ບາ^ລິມ
Sofim	ໂສ^ຟິມ
Aalotv	ອາ^ລົດ
bieqc bieqc	ເປັຍໆ
zie'fongc	ເຕສ່ຍຝົ່ງ
Se^mbaam	ເສ^ບາມ
Atc^lotv^so^faan	ອັດ^ລົດ^ໂຊ^ຟານ
Mbetc Nimlaa	ເບດ^ນິມ^ລາ
Makv^he^lotv	ມັກ^ເຮ^ລົດ
Mo^se^lotv	ໂມ^ເຊ^ລົດ
Anmon Ndipc^laa^taa^im	ອັນ^ມົນ^ດິບ^ລາ^ທາ^ອິມ
Se^ndatc	ເສ^ດັດ
# This is already in the  list
# Haasaa Lenan	ຮາ^ຊາ^ເລ^ນັນ
Iu-Mienh	ຢິວ-ມ່ຽນ
bungh bungh	ປູ້ງໆ
# Mbetc^Holon already exists 
#Mbetc Holon	ເບດ^ໂຮ^ລົນ
Mitv^le^fotv Maa^im	ມິດ^ເລ^ຟົດ^ມາ^ອິມ
Simlon Melon Mungv	ຊິມ^ລົນ^ເມ^ລົນ ມູ້ງ
Naafotv Ndo^aa	ນາ^ຟົດ^ໂດ^ອາ
Mbaa^motv Mbaa^an	ບາ^ມົດ^ບາ^ອັນ
Ze^e^letv Saa^haax	ເຕສ^ເອ^ເລດ^ຊາ^ຫາ
Kinaa	ຄີ^ນາ
Mbetc Hokv^laa Mungv	ເບດ^ຮົກ^ລາ ມູ້ງ
Mbe^aa^lotv	ເບ^ອາ^ລົດ
Haaso Haa^ndatc^taa	ຮາ^ໂຊ^ຮາ^ດັດ^ທາ
Mbetc Beletv	ເບດ^ເປ^ເລດ
Se^nan	ເສ^ນັນ
Kitv^litv	ຄິດ^ລິດ
Mbetc Ndaagon	ເບດ^ດາ^ກົນ
Mbetc Tapv^bu^waa	ເບດ^ທັບ^ປູ^ວາ
Mbetc Aanotv	ເບ^ທາ^ນົດ
Aa^taa^lotv Atc^ndaa Laangz	ອາ^ທາ^ລົດ^ອັດ^ດາ ລ໌າງ
Mbetc Se^aan	ເບດ^ເຊ^ອານ
Mbetc Aa^laa^mbaa Laangz	ເບດ^ອາ^ລາ^ບາ
Mbetc Hokv^laa	ເບດ^ຮົກ^ລາ
Se^maa^laa^im	ເສ^ມາ^ລາ^ອິມ
Mbaac^Aac^latv Mbec^Ec^mungv	ບາ^ອາ^ລັດ^ເບ^ເອ ມູ້ງ
Kitv^lotv Taa^mbo Mungv	ຄິດ^ລົດ^ທາ^ໂບ ມູ້ງ
Etc Kaasin Mungv	ເອດ^ຄາ^ຊິນ ມູ້ງ
Ipc^taa En Horngz	ອິບ^ທາ^ເອນ ຮ໌ອງ
Ke^sunx^lotv	ເຄ^ສຸນ^ລົດ
Mbetc Batc^setv	ເບດ^ປັດ^ເຊດ
Atc^notv Taa^mbo	ອັດ^ນົດ^ທາ^ໂບ
Se^aa	ເສ^ອາ
En Haaso	ເອນ^ຮາ^ໂຊ
In Semetv	ອິນ^ເຊ^ເມດ
Mbe^ne Mbelaakv	ເບ^ເນ^ເບ^ລາກ
Timnaatv Heletv	ທິມ^ນາດ^ເຮ^ເລດ
Sefatv	ເສ^ຟັດ
Mbetc Aanaatv	ເບດ^ອາ^ນາດ
Haa^lo^setv Haa^go^yim	ຮາ^ໂລ^ເຊດ^ຮາ^ໂກ^ຢິມ
lorpc lorpc	ຫລອບໆ
Melotv	ເມ^ລົດ
Se^le^laa Mungv	ເສ^ເລ^ລາ ມູ້ງ
Mbetc Qitv^taa Mungv	ເບດ^ທຈິດ^ທາ ມູ້ງ
Mbetc Mbaa^laa Saengv	ເບດ^ບາ^ລາ ແຊ້ງ
Se^epc	ເສ^ເອບ
# also exists with out ^ between
#Mbaa^an Mbelitv	ບາ^ອັນ^ເບ^ລີ້ດ
Mbelitv	ເບ^ລີ້ດ
Laamaatv Lehi	ລາ^ມາດ^ເລ^ຮີ
Solekv	ໂສ^ເລກ
ding ding	ຕີງໆ
ndutc ndutc	ດຸດໆ
huov-jeix	ຮວົ້ວ-ເຈີ໋ຍ
nyapv nyapv	ຍັບໆ
sekv sekv	ເຊກໆ
Se^mbo^im Horngz	ເສ^ໂບ^ອິມ ຮ໌ອງ
nyanh nyanh	ຍັ່ນໆ
mingh mingh	ມີ່ງໆ
Si^laa^aa	ສີ^ລາ^ອາ
youh youh	ໂຢ້ວໆ
O^mbetc E^ndom	ໂອ^ເບດ^ເອ^ດົມ
ndoqc ndoqc	ໂດະໆ
Itc^mbi^mbe^nopv	ອິດ^ບີ^ເບ^ນົບ
mbungh mbungh	ບູ້ງໆ
Yoqc^epv Mbatc^Qev^mbetc	ໂຢ^ເທຈບ^ບັດ^ເທຈ^ເບດ
Saamaa	ຊາ^ມາ
Qiqaa	ຈີ^ທຈາ
njoux njoux	ໂອຈ໋ວໆ
Elotv	ເອ^ລົດ
minaa	ມີ^ນາ
Se^le^ndaa	ເສ^ເລ^ດາ
hiou	ໂຮຢວ
He^si^on	ເຮ^ຊີ^ອົນ
njoh njoh	ໂອຈ້ໆ
suqv suqv	ຊຸໆ
Saen^maa^ne^se	ແຊນ^ມາ^ເນ^ເສ
So Hungh	ໂສ ຮູ່ງ
Hepv^si^mbaa	ເຮບ^ຊີ^ບາ
Haa^lutv	ຮາ^ລຸດ
Lumaa Mienh	ລູ^ມາ ມ່ຽນ
Utc^Sen Sev^Elaa	ອຸດ^ເຊນ^ເຊ^ເອ^ລາ
Se^naa^aa	ເສ^ນາ^ອາ
Si^haqc	ສີ^ຫະ
Si^aa^haa	ສີ^ອາ^ຮາ
Kelotv	ຄ^ລົດ
Me^hi^ndaa	ເມ^ຮີ^ດາ
Mbaa^kotc	ບາ^ຂົດ
Sotai	ໂສ^ໄທ
Hatc^so^fe^letv	ຫັດ^ໂສ^ເຟ^ເລດ
Kitv^lepv	ຄິດ^ເລບ
Mbe^so^ndai^aa	ເບ^ໂສ^ໄດ^ອາ
So^fe^letv	ໂສ^ເຟ^ເລດ
Min^yaa^min	ມິນ^ຢາ^ມິນ
Gingaan	ເບດ^ກິນ^ການ
biangh biangh	ປຢັ້ງໆ
Setaa	ເສ^ທາ
Maan^se^naa	ມານ^ເສ^ນາ
daaih daaih	ຕ້າຍໆ
hungh hungh	ຮູ່ງໆ
mba'ae	ບັ໊ແອ
lungh lungh	ລູ່ງໆ
laih laih	ໄລ່ໆ
ba'nai'h	ປະໄນຮ
mbokc mbokc	ບົກໆ
coh coh	ໂທສ່ໆ
haev haev	ແຮ້ໆ
